1 Connector Electric	Joe@ConnectorElectric.com
1 ETI Services, Inc.	sales@wedosolar.com
1 Next Generation Solar Inc.	info@csbcinc.com
1 Stop Home Remodeling Inc	jude@1stophomeremodel.com
12-Gauge Electric	solar@12-ge.com
12-Gauge Electric, Inc.	Haim@12-ge.com
1st Choice Solar Construction	tony.1stchoicesolar@gmail.com
21st Century Electric Solutions	21stCES@gmail.com
32 Degrees Solar	32solar@gmail.com
360 Solar Energy, Inc.	kamaradio@360solarenergy.com
3D DATACOM	sdales@3ddatacom.com
3FFICIENT Energy	sales@3fficient.com
3G Electric, Inc.	3gei@3gelectricinc.com
3phase Electric co.	3phaseelectricalco@gmail.com
3snetwork	mikewilson569@yahoo.com
411GreenWave	info@411greenwave.com
9 Star Construction, Inc.	9starco@gmail.com
A & A Tops	aatopsmanager@aol.com
A & E Homremodeling	aehomeremodeling@aol.com
a 1 solar power inc	Patrick.Detchman@a1solarpower.net
A 2 Z Energy	michael@a2zenergy.com
A 24 Solar Corporation	a24solar@yahoo.com
A B L Energy	sales@solarsystemsintl.com
A C L Construction Company	arthurw0409@yahoo.com
A C S Construction LP	acsdien@earthlink.net
A CONSTRUCTORS	ACONSTRUCTORS@HOTMAIL.COM
A Giddens Electric Inc	solar@giddenselectric.com
A J Electric	gneverov@yahoo.com
A J Kirkwood & Associates Inc	ss@ajk-a.com
A L Chacham	julie@alchacham.com
A Lighting By Design	chad@alightingbydesign.com
A PLUS QUALITY CONSTRUCTION, INC	mdoyer1@cox.net
A$A Electric Co	aachimi@yahoo.com
A&A Solar and Construction	oquist5@yahoo.com
A&F CONTRACTORS	redoz10@yahoo.com
A-1 Contractors Inc.	louis@a-1electric.net
A-1 Electric	info@a-1electricinc.com
A-1 Electric Discount Service Inc.	a1solarpower@verizon.net
A-1 Electric Discount Service Inc	plyby71mn4@aol.com
A-1 Maintenance	a-1energysolutions@hotmail.com
A-1 Solar Power	plyby71mn4@aol.com
A-Aeerial Service Co. Inc.	team@aaerial.com
A-Avis Plumbing-Heating & Air Conditioning, Inc	avis_air@hotmail.com
A-C Electric Company	davemorton@a-celectric.com
A-RAYMAN ELECTRIC, INC	ARAYELECTRIC@SBCGLOBAL.NET
A. L. L. Save Construction, Inc	allsave@frontiernet.net
A.I.T. Development Corp	Formyhome@megabuilders.com
A.J. Builders	ajbuild1@sbcglobal.net
A.M. LaSalle Electric, Inc	gary@lasallelighting.net
A.M. Sun	info@amsunpower.com
A.M. Sun Power	lauren@amsunpower.com
A.M. Sun Solar	cory@amsunsolar.com
A.M.Martinez Construction, Inc.	ammartinezconstruction@gmail.com
A.M.Shine Electric Inc.	janis@AMShineSolar.com
A1 SOLAR POWER	info@a1solarpower.net
A1 SOLAR POWER INC.	info@a1solarpower.net
A1 Sun, Inc.	info@a1suninc.com
AAA Solar Construction	aaa.solar.sandy@gmail.com
AAA Solar Electric, Inc.	dngo@aaasolarelectric.com
AAA Steiner's Solar Service	steinersolar@hotmail.com
ABC Cooling and Heating	markm@abccooling.com
ABC Mountain Solar	abcmountainsolar@verizon.net
ABC Podunk Solar	misc@eschen.us
ABC Solar, Inc	solar@abcsolar.com
Abel's Construction	abelsconstruction@gmail.com
Abilene Electric, Inc.	Marina@abilene-electric.com
Able Construction & Electric, Inc	ibdnrgguy@gmail.com
Above All Construction	sales@aboveall-construction.com
Abraham H. Zapata Construction	zapataconstruction@hotmail.com
ABS Netcom Inc.	ccj@solariumenergy.com
Absolute Electric And Service Company	info@absoluteelectricandsolar.com
Absolute Electric Eric Tisher	eric.tisher@gmail.com
Absolute Power Systems	fjoga@aol.com
Absolutely Electric	absolutelyelectric@cox.net
Absolutely Solar, Inc.	peter@absolutelysolar.com
AC&R Service Heating & Cooling, Inc.	acr_vaughn@pacbell.net
AC/DC Systems	frank@acdcsystems.net
ACA Solar Inc.	cnc@acasolar.com
ACA Technology Inc	cnc@acatec.com
ACA Technology, Inc.	david@acasolar.com
Accend Energy, Inc.	sales@accendenergy.com
Access Solar, Inc.	access.solar@ca.rr.com
acclaim electric inc.	acclaimelectricinc@gmail.com
Accurate Comfort Systems, Inc	comfort@actionac.net
Accurate Comfort Systems, Inc.	comfort@actionac.net
Accurate HS Inc	jeff.seale@accurateelectricalservices.com
Ace Construction	acesolar@aol.com
Ace Design, Inc.	racevedo@solaruniverse.com
Acecon Inc.	admin@amekogroup.com
ACI CONSTRUCTION CO.	solarman.orozcopm@gmail.com
ACR Solar International Corp	richsolar@aol.com
ACS Group	darrel@acsgroup-usa.com
Action Air Conditioning, Heating & Solar	comfort@actionac.net
Action Construction Specialist	Action@actionconstruction.net
Active Solar, Inc.	info@activesolarinc.com
Addy Electric	danny@addyelectric.com
Adelbai Electric	adelbai.electric@gmail.com
ADM Electric Company	admelectriccompany@gmail.com
ADR Electric Inc.	info@adrsolarsolutions.com
Adriatic Builders & Solar Contractors	dejan@adriaticbuilders.com
Adromeda Solar, Inc.	sales@solartechnologies.com
Advance Air Concepts, Inc	philh@asaaco.com
Advance Power Redding	info@energytechrdg.com
Advance Solar, Hydro, Wind Power Co. Inc.	advance@advancepower.net
Advance: Solar, Hydro, Wind Power Inc	advance@advancepower.net
Advanced Alternative Energy Solutions	info@aaes.biz
Advanced Comfort Solutions	lrohleder@advcomfort.com
Advanced Commercial Enterprises	info@acesolarspecialists.com
Advanced Electric & Sound	wayne@AESchico.com
Advanced Electrical Contractors	aec@covad.net
Advanced Energy	lon@saber.net
Advanced Energy & Comfort Solutions	tshelton@netptc.net
Advanced Energy Construction	lon@saber.net
Advanced Energy Solutions, Inc	info@advancedenergysi.com
Advanced Green Builders	info@advancedgreenbuilders.com
Advanced Home Energy	ahe@advancedhomeenergy.com
Advanced Home Energy, Inc.	marketing@advancedhomeenergy.com
Advanced Improvements	athena@advancedimp.com
Advanced Powering Services, Inc.	tim@apsincorp.com
Advanced Solar Electric, Inc.	info@ase4u.com
Advanced Solar Energy	kg70@yahoo.com
Advanced Solar Systems	goeppinger100@yahoo.com
AEI-CASC Consulting	aardis@aei-casc.com
Aeos Electric	info@aeos.us
AeroSun Electric	atuffley@aerosunelectric.com
AES	aes.spears@yahoo.com
AES Alternative Energy Systems Inc.	depettey@cox.net
Aeterna Energy, LLC	rharris@aeternaenergy.com
Affinity Solar Energy, Inc.	info@affinityenergy.com
Affordable A/C	jvampola@yahoo.com
Affordable Electricians, Inc.	affordable.electricians.inc@gmail.com
Affordable Solar Group, LLC	sales@affordable-solar.com
AG & B CONSTRUCTION	agbconstruction@att.net
Ahh...SHE'S A HOUSE DOCTOR	shebuildsgreen@sbcglobal.net
AIC Electric	info@aicelectric.com
AIKYUM INC	aikyum@energyrebateoutlet.com
Aikyum, Inc.	harina@aikyum.com
AIM Consulting Services	gperez@aimcsworld.com
Air Conditioning Unlimited, Inc.	david@acunlimitedinc.com
Air Squared Mechanical	jay@air2mechanical.com
AIR SUN, Inc.	cwklint@earthlink.net
airmaxx,inc	acaglozman@gmail.com
AIT Studio, Inc.	alex@aitstudio.com
AJH Construction Inc.	ajhconstruction@hotmail.com
AJN ELECTRIC	www.andrewjnunez@yahoo.com
ajs electric	ajselectric21@gmail.com
AK Electric Inc.	kleins.acton@roadrunner.com
Akeena Solar, Inc	sales@akeena.com
AKESolar Inc	info@akesolar.com
Al Fresco Concepts Inc	sean@frescosolar.com
Alan Goldberg Electric	solarserviceguy@gmail.com
Albion Power Company	cadams@albionpower.com
Alchemy Construction	info@alchemyinc.com
Alderete Pools Inc	ray@alderetepools.com
AlertOne, Inc.	christopher@alertoneusa.com
Aliso Electric, Inc	karla@alisoelectric.net
ALIVE Industries Inc.	adam@aliveindustries.com
All American Air & Solar Systems	mark-kimberly@sbcglobal.net
All American Design Inc.	allamericandesign1@gmail.com
All American Plumbing Heating & Air	allamericanpha@att.net
All Bay Painting & Wood Preserving	allbaypainting@yahoo.com
All Bay Solar	Info@allbaysolar.com
ALL CITY SERVICE COMPANY	mfondie@sbcglobal.net
All Climate Air inc	debbie@allclimatesolar.com
All County Roofing	mhyepock@majorleagueroofers.com
All Current Electric	allcurrentelectric@gmail.com
All Home Comfort	dave@ahcservice.com
All In One Construction	ralph@greenrealitiesllc.com
All On Electric	allonelectric@gmail.com
All Phase Electric, Inc	ryanallphaseelectricinc@gmail.com
All Phase Heating & Air Conditioning	dorinb@sbcglobal.net
All Phases Electric	ooooooooo@ooo.net
ALL Save Energy	larry@allsaveenergy.com
All Seasons Roofing Services	solar@allseasonsroof.com
All Seasons Solar Inc.	Allseasonssolar@aol.com
All Solar Electric	info@solarpowerinstall.com
All Star Contractors HB	Chrisv@pwrlogix.com
All Star Electric	jose@allstarelectric-ca.com
All Star Solar USA Inc.	bonniekirby@allstarsolarusa.com
All Temperature Air & Solar	chad@alltemperatureair.com
All Valley Solar	ted.bavin@allvalleysolar.com
All Wire Electric, Inc.	allwireinc@gmail.com
All Wire Systems	office@allwiresystems.com
All Year Solar, Heating & Air	brian@allyearah.com
All-Sol Inc.	info@all-sol.com
Allana Buick and Bers Inc.	akaffka@abbae.com
Allen Associates Construction	ljohnson@dallenassoc.com
Allen Construction	energy@buildallen.com
Allen Electric Inc.	allenelectric3@yahoo.com
Alliance Energy & Mechanical Inc.	info@aeminc.net
Alliance Energy Company	alliance.energy@gmail.com
Alliance Solar Services	af4solar@comcast.net
allied constructors	aconstructors@hotmail.com
Allied Energy, Inc	simon@alliedenergy-us.com
Allied Solar	info@allied-solar.com
Allmon	pfadfinder03@yahoo.com
AllNuEnergy inc	steve@allnuenergy.com
AllPoint Electrical and Data, Inc.	cnelson@allpointelectrical.com
Allstate Engineering	joshc@allstate-engineering.net
Allstate Solar Integration, Inc	jays@burlingameindustries.com
Alltec SunEnergy	jerry@alltec-nv.us
Alltech Solar, Inc.	fcarmody@alltechusa.com
Allterra Environmental, Inc.	james@allterraenv.com
Ally Electric & Solar Inc.	metin@allyelectrical.com
Ally Electric and Solar inc.	info@allyelectrical.com
Ally Electric and Solar, Inc.	metin@allyelectrical.com
Almanor Energy Plus, Inc.	almanorenergy@yahoo.com
Almansky Corporation	alexalmansky@gmail.com
Almansky Corporation	alexalmansky@gmail.com
Aloha Systems Incorporated	MarkS@alohasys.com
Alpha Greensolar Inc	admin@alphagreensolar.com
Alpha Omega Electric	antakelectric@gmail.com
Alpha Technologies Services	ahixson@alpha.com
Alpine Custom Construction	eli@alpineccinc.com
Alpine Electric	alpineelectric@cruzio.com
Alpine Green Property Services	info@alpinegreenps.com
Alpine Homes Design & Const.,Inc.	alpinehomes@jps.net
Alpine Solar Electric	alpinesolar@sbcglobal.net
Alta West Electric, Inc.	altawestelectric@yahoo.com
Alter Systems, LLC	andres@altersystems.com
Alternate Energy Innovations Construction	Brendan@myaei.com
Alternate Power & Construction	cstz@sbcglobal.net
Alternative Energy , Inc.	cat@capowersave.com
Alternative Energy Designs, Inc.	aed@mlode.com
ALTERNATIVE ENERGY DEVELOPMENT CORP	info@windnenergy.com
Alternative Energy Financing LLC	aei2@sonic.net
Alternative Energy Inc.	cchondo@alternaitveenergyinc.com
Alternative Energy Services, Inc.	ray@altenergyservices.com
Alternative Energy Specialists,LLC	motoolito@dishmail.net
Alternative Energy Systems, Inc.	info@solarenergyforlife.com
Alternative Energy Systems, Inc.	info@solarenergyforlife.com
Alternative Energy Technologies	info@altenertec.com
Alternative Green Energy, Inc.	vsmedina@aol.com
Alternative Power & Electric	bcaschera@alternativepowerandelectric.com
Alternative Power Generation Inc	brent@apgsolar.com
Alternative Power Solutions, Inc.	apsadmin@apsSolarPower.com
AltSys Solar Inc.	jramsey@altsyssolar.com
AlvisProjects, Inc.	marlin.magic@sbcglobal.net
ALX Company	alxco@pacbell.net
AM Construction	emsrupp01@gmail.com
AM Electrical & Solar	mperi@amelectricalandsolar.com
Amazing Electric Inc.	joanna@amazingelectricinc.com
Ambassador Energy, Inc	info@ambassadorenergy.com
Ameco Solar Inc.	solarpro@aol.com
Ameco Solar, Inc.	gosolar@amecosolar.com
AMEKO APS	admin@amekogroup.com
Ameko Inc	mrokmc@sbcglobal.net
Ameresco	tdollase@ameresco.com
Ameresco Solar	sales@amerescosolar.com
American Asset Management, Inc	info@aamcontracting.com
AMERICAN CANYON ELECTRIC	amercanyonelect@comcast.net
AMERICAN ELECTRIC	CTRUMBAUER@GOTELECTRICAL.COM
American Electrical Services Inc.	iv@aessolarpro.com
American Energy Solutions	a1americanenergysolutions@yahoo.com
AMERICAN ENERGY SYSTEMS INC	mario@americanesystems.com
AMERICAN GREEN ENERGY	hero@AGEofSolar.com
American Management Services	info@solartecusa.com
American NRG, Inc.	bwatson@americannrginc.com
American Republic Enterprises Inc.	theare@sbcglobal.net
American Resources Corporation	hank@hycengineer.com
American River Electric	mtraco@aol.com
American Sheet Metal	johng@americansheetmetal.us
American Solar & Electric	mikespiering@yahoo.com
American Solar Advantage	info@americansolaradvantage.com
American solar Construction&home remodeling	info@americansolarsolution.com
American Solar Corporation	rebates@americansolar.net
American Solar Direct	marketing@americansolardirect.com
American Solar Direct Inc.	info@asdsolar.com
American Solar Power	john@asolarp.com
American Solar Power Inc	edwin@asolarp.com
American Solar Pros	info@americansolarpros.com
American Solar Solution	americanhremodeling@gmail.com
American Solargy Inc.	kwashington@americansolargy.com
American Vision Solar	vanessa@americanvisionsolar.com
American West Construction Inc	cecil.wilson11@gmail.com
American-Asia Int'l Inc.	Larry.aaiisolar@gmail.com
Ameritech Construction Inc.	kevin_park@ameritechinc.net
Ames Construction	jkamesrn@aol.com
AMG & Associates, Inc.	albert@amgassociatesinc.com
AmGreen Solar & Electric	james@amgreensolutions.com
Amp Industries	matt@ampindustriessolar.com
Amplex Electrical Inc.	amplexelectrical@comcast.net
AMREIN ELECTRIC	lamrein@verizon.net
AMTRAN	asingh@socal.rr.com
Anand G DeSouza	adam@indussolar.net
Anatone Corp.	tonyc@anatonecorp.com
Anavar Electric	anavarelectric@att.net
Anco Design Build	russ@ancodb.com
Anderson Construction	norm@andersonconstruction.us.com
Anderson Solar Controls	brian@andersolar.com
Andrew Construction	sikim1966@gmail.com
Andrew G. Crown Electrical	acrown@att.net
Andrew Lewis Construction	andrewlewis39@gmail.com
andrews electric	andrewsem1@hotmail.com
Anewel Inc	wb@bligh.com
Angelic Construction	vinceangelowilliams@gmail.com
Anil Uppal	neal@solartopps.com
ANR Crown Roofing	freeestimates@anrcrownroofing.com
Anthony J Durst construction	anthonyjdurst@gmail.com
apex building construction,inc	info@apexvisit.com
Apex Solar	mroffgrid@verizon.net
Apex Solar Inc.	info@apexsolarinc.com
Applied Electrical & Distribution	rob@appliedelectrical.com
Applied Solar Energy Solutions	Sales@AppliedSES.com
Aramexx Solar	sal@aramexxsolar.com
Araz Electric Inc.	araz.electric@yahoo.com
Arcadia Electric	smatta@arcadiaelectric.com
Arce Electric	arce.electric@aol.com
Archbold Electric Inc.	aradon@sbcglobal.net
Archer Roofing	Roofmanarcher@att.net
Arck Electrical, Inc.	arck@att.net
ARCO ELECTRIC	metin@arcoelectrical.com
arev solar	josephr@arevsolar.com
Argent Solar Electric	info@argentsolar.com
Argon Construction	michael@argonconstruction.com
Argon Construction Inc	michael@remodelnet.com
Argon Construction Inc.	mike@argonconstruction.com
ARIES ELECTRIC	elkabong333@yahoo.com
Arise Construction Inc	glenn@arisesolar.com
Ark Construction and Development, INC	kambiz@arkcdinc.com
Ark construction inc	jonathan_hoang@juno.com
Arkay Solar and Electric	bob@arkaysolar.com
Armor Construction and Design, Inc.	armorconstruction@live.com
Armor Electric	Inquiry@armorelectricsolar.com
Arnold Martinez General Engineering CSLB #842034	martinez.arnold@sbcglobal.net
Around Town Electric	aroundtownelectr@aol.com
Arrow Electric, Inc.	mark@aeinc.co
ArrowBear Electric, Inc	arrowbearelect@aol.com
Artisan Roofing Co., Inc	wade@artisansolarroofing.com
Artisan Roofing Company, Inc.	wadewoodward@sbcglobal.net
ARTWORK BUILDERS INC	JAMES@COLOREDSOLARSANDIEGO.COM
Ascend Building Systems, Inc.	postmaster@ascendbuilding.com
ASE Solar Solutions, Inc	mferrari@asesolar.com
Asgard Electric	service@asgardenergyco.com
ASI Hastings, Inc.	philj@asiheatingandair.com
Asolia Inc.	eugenia@gmail.com
Asolia, Inc.	msharma@asolia.com
Aspen Electric Inc.	admin@aspenelectricllc.com
Associated Community Solar Sciences	Sales@SolarSciences.biz
Associated Construction Services Group	darrel@acsgroup-usa.com
Associated Services Heating-Solar-Air	richardc@associatedheating.net
Assured Professionals, Inc.	normhennin@aol.com
Astro Air Design, Inc.	astroairdesign@sbcglobal.net
Astrum Solar, Inc.	info@astrumsolar.com
Atkinson Climatrollers, Inc.	cfaulkner@valleyheating.com
Atlas Solar Inc.	info@atlassolarinc.com
Atlas Solar Inc.	atlas.solar@yahoo.com
Atwater Home Renewal & Construction	info@atwatersc.com
Auburn Electric Inc	peggy@auburnelectricinc.com
aundrue electric	aundrueelectric@gmail.com
Automated Control Inc	office@automatedcontrolinc.com
Automated General Contracting, Inc.	steve.jdk@mpowercom.net
Automation Solar	info@automationsolar.com
AWS Electrical & Solar Inc.	solar@awses.com
Axion Solar, LLC	cs@axionsolar.com
AZ Solar, Inc.	michaellukeli@gmail.com
Aztec Solar Inc	sales@aztecsolar.com
B & B Solar	bgummsolar@gmail.com
B A Construction	massoudt@aol.com
B&B Harvey Construction	bharvey@surewest.net
B-D Quality Water	joe@b-dqualitywater.com
B-Radiant	bradcote@b-radiant.com
B.J.M. Construction	BJMConstruction2006@yahoo.com
Backe Electric Inc	hotrodta@roadrunner.com
Bailey Electric	manfredthyssen@yahoo.com
Baize Electric and Solar Technologies	Sales@solarbest.co
Bajea Group, Inc.	bbaley@ciservicesinc.com
Baker Builders	phil@oceanviewsolar.com
Baker Electric Solar	info@bakerelectricsolar.com
Baldi Bros Inc.	mparton@baldibros.com
Ball CM, Inc.	chris@ballcm.com
Banana Solar	swartzlander1@gmail.com
Barden Electric, Inc.	leeb@bardenelectric.com
Bardsley Construction Inc	robertbardsley@yahoo.com
Barnes Solar Inc.	ricky@barnessolar.com
Barnett's Energy Wise Inc.	barnettsenergy@gmail.com
Barnum and Celillo Electric, Inc.	mdavis@barnumcelillo.com
Baron Solar & Electric	joel@baronsolar.com
BARRETT BOARD RENEWABLES, LLC.	mwhiteley@ridgecrestrenewables.com
Barrier Specialty Roofing and Coatings, INC.	andy@barrierroofing.com
Barrus Electric	barrussolar@gmail.com
Bart's Contracting	BartsContracting@socal.rr.com
Barth Construction Inc.	bruce@barthmountainhomes.com
Bautista Builder	mbautista66@yahoo.com
Bay Area Energy Solutions, Inc.	jware@bayenergy.com
Bay Area Solar Solutions, Inc.	jim@yourenergysolutions.com
Bay Area Systems & Solutions	alarner@basselectric.net
Bay Electric and Solar	kevin@bayelectricandsolar.com
Bay Heating and Air Conditioning	bayheating@yahoo.com
Bazua Roofing	alfredobazua68@gmail.com
BBJ Electric Inc	info@bbjelectric.com
BC Builders	brentferrera@gmail.com
BCC Solar	matt@bccsolar.com
BDS	bdsolar@earthlink.net
BDS Solar	matt@bdssolar.com
BDS Solar, Inc.	info@bdssolar.com
Beach Cities Solar	beachcitiessolar@cox.net
BEACH CITIES SOLAR INC	beachcitiessolar@cox.net
Bebow's Heating, Air & Home Improvements	Bruce@Bebows.com
BEC Electric, Inc.	edanielson@becelectricinc.com
Bechtel Property Services,Inc.	bpsi@bechtelinc.com
Beckman Electric & Supply	dave@innovativepools.com
Bedrock Solar	jans@bedrocksolar.com
Behnke Enterprises, Inc.	info@weknowbest.com
BEI Construction, Inc.	info@beiconstruction.com
Belco Electric, Inc.	jbernardino@belcoelectric.org
Bell Solar Electric, LP	bellsolar@yahoo.com
Bella Electric	Bellasolar@gmail.com
Belmont Energy	joe@belmont-energy.com
Ben & Li Corporation	benandlicorp@hotmail.com
Ben Holtz Consulting Inc	ben@fallbrook-solar.com
Bender Engineering and Construction, Inc.	jeff@becx.net
Bene Electric and Solar PV	colebene@beneelectric.com
Benz Air Engineering Co.	robert@BENZAIR.COM
Bergelectric	info@bergelectric.com
Berger Electric	scott@bergerelectricandsolar.com
Berkeley Solar Electric Systems	markf@berkeleysolar.com
Berkley Construction	keith@berkhome.com
BESolar Inc	paul@besolar.com
BEST Contracting Services, Inc.	info@bestcontracting.com
Best of Trades Corp	igaalbarak@gmail.com
Best Solar Power	bestsolar@att.net
Best Solar Power, Inc.	bestsolar@att.net
BEST TEC	val@besttecservice.com
Betmar Construction	mbennett@betmarconstruction.com
Better Home Energy	bill@thebetterhomeenergy.com
Better Homes Construction	betterhomesconst@aol.com
Beutler Corporation	wyliec@beutlercorp.com
BGreenLA	info@bgreenla.com
Big Mountain Air	steveg@bigmountainair.com
Bill Sharp Electrical Contractor	bsharpelectric@yahoo.com
Bingham Construction Company, Inc.	jbingham@bingham-construction.com
Black Diamond Electric, Inc.	jake@blackdiamondelectric.com
Black Rock Solar, Inc.	contact@blackrocksolar.org
Blackmore Electrical, Inc.	brian@blackmoreelectrical.com
Bland Solar & Air, Inc	scott@Blandsolar.com
Blankenship Electric and Communications	steve@blankenshipelectric.net
Bleyco, Inc	bleyco3@sbcglobal.net
Blossom Valley Solar	blossomvalleysolar@gmail.com
BLS Construction	ben@blsconstructioninc.com
Blue Hills Development	bhdinfo@yahoo.com
Blue Oak Energy, Inc	information@blueoakenergy.comr
Blue Pearl Builders, Inc.	davideoldham@hotmail.com
Blue Skies Solar	blueskiessolar@yahoo.com
Blue Sky Energy	info@blue-sky-energy.com
Blue Sky Solar	blueskysolar@wildblue.net
Blue Spectrum Solar, Inc	info@bluespectrumsolar.com
blue tech build	juyoung@live.com
Blueline Solar Power	info@bluelinepower.com
Blum & Sons Electric Inc	jeblum@blumelectric.com
Blum Electric	kory.blumelectric@yahoo.com
BMB Construction Properties	info@bmbcp.com
BMR GROUP OF COMPANIES, INC	BILL@B3INV.COM
BNT Construction	bothai@Yahoo.com
Boersma Construction Corporation	info@mywestcoastgreen.com
Bolle Electric	solar@bolleelectric.com
BOLT ELECTRIC	ron@boltelectric.pro
Bolton Electric	sherdbolton@hotmail.com
Bonanza Development & Construction, Inc	Bpoteet4@cox.net
Bonham Electric	bonhamelectric@gmail.com
Bonterra	mmurbarger@bonterrasolar.com
Booth Construction	rdbconst@yahoo.com
BOP Renewables, Inc.	boprenewables@gmail.com
Borges Bros, Inc.	mmurph10@calpoly.edu
Borrego Electric	borregoelectric@sbcglobal.net
Borrego Solar Systems, Inc.	astice@borregosolar.com
Boschetti Construction Incorporated	pboschetti2001@yahoo.com
Boston Brick and Stone	ron@bostonbrick.com
Bosworth Solar Electrical Systems	TimB@ValleyCenterSolar.org
Bothwell Construction Corp	glenn@bothwellcorp.com
Boykin & Boykin Construction	bbconstruction1@msn.com
BPG ELECTRIC	bgamberg@cox.net
Brandt Construction	barrybrandt@msn.com
Brannon Inc.	mb@smith-electric.com
Branover Contractors, Inc	info@branovercontractors.com
Brant Electric	meporter@asis.com
Bravo's Construction	wraguayo@aol.com
Brayer Electric Company	steve@brayerelectric.com
Brazil Quality Roofing Inc.	mdbrazil@brazilqualityroofing.com
Brendan Molony Electric	brendan.molony@yahoo.com
Brennan Electrical	brennanelectrical@gmail.com
Brentwood Electric	brentwood-electric@hotmail.com
Brian Hall Electric & Construction	bhelect@sbcglobal.net
Brian Hastain Construction	bndhastain@msn.com
Brian Hobbs Roofing, Inc.	bhroofing@sbcglobal.net
Brian Mauro Construction, Inc.	hmauro805@aol.com
Brian Rice Construction Inc	brian@brconstruction.com
Brian S Puckett Electrical	badbrian359@gmail.com
Briggs Electric, Inc.	JeffP@briggselectric.com
Bright Future Solar Energy, Inc.	heath@bfse.co
Bright Impressions Inc.	robroofer63@yahoo.com
Bright Life Solar	vin@brightlifesolarsystems.com
Bright Power, Inc	sales@bpi-power.com
Bright Star Energy, Inc.	sales@sdsolarguys.com
BrightSolar Capital LLC	info@brightsolarcapital.com
Brooks Technical Electrical	ron@brookstechnicalelectrical.com
Brooks Works Corp.	glen2ns@gmail.com
Brothers Solar	info@brotherssolar.com
Brothers Solar Electric	adeh@brotherssolar.com
Brower Mechanical Inc	info@browermechanical.com
Brower Mechanical, inc	kayet@browermechanical.com
Brower Mechanical, Inc.	duane@browermechanical.com
Brown's Quality Electric	bqejb@comcast.net
Brumbaugh Enterprises, Inc. DBA Electrix	stu@eltrx.net
Bryan Temmermand, General Contractor	bryan@temm.co
Bryson Construction	sunesolar@yahoo.com
BTA Solar	rich@btasolar.com
Buchholz Roofing & Construction	tonybuchholz@yahoo.com
Buck's Ranch Inc.	solarguy@verizon.net
Buckley's Heat & Air Inc.	brian@buckleyheatairsolar.com
budget air	buddyl33@yahoo.com
Budget Electrical Contractors , Inc	dguy@becelectric.com
Buell Construction Corp.	info@yuma-solar.com
Buescher Electric Inc	buescherelectric@gmail.com
Build To Sustain, Inc	info@lagreenbuilding.com
BUILDING CONSULTING ENGINEERSS INC	engineer@bcesolar.com
Building Enhancement Network, Inc	ben@benincca.com
Building Performance M.D.	jerry@buildingperformancemd.com
Built Green California, Inc.	chuck@builtgreencali.com
Bullert Industrial Electric, Inc.	brenda@bullertindustrial.com
Bulterman Electric	rasbaboo@cruzio.com
Burke Electric	aburke.electric@verizon.net
Burth Electric	jburth@burthelectric.com
Bustamante Enterprises, LLC	ralph@yourelectricsolution.com
Busy Bee Solar	steve@busybeesolar.com
Butch B Electric	butchbelectric@charter.net
Butterfield Electric	gary@butterfieldelectric.com
BYC Construction, Inc.	peter@bycconstruction.com
Byers Solar	solar@thatsbyers.com
C & C Solar Inc	candcsolar@att.net
C K ELECTRIC	ckelectric@cox.net
C M C CONSTRUCTION	kberry77@verizon.net
C-K Construction Co	tuanpc2000@gmail.com
C.F. Promotions	cf@swansolar.com
C.F. Promotions Inc	cf@swansolar.com
C.R Superior Solar Inc	SperMech@msn.com
C.R.L. Electric Inc.	crlchrisluna@aol.com
C6 Solar Corporation	ghearn@c6cg.com
CAB Construction	info@granitebayenergy.com
Cable Sun Crafters Inc	jherbst@solaruniverse.com
Cal Casa Roofing Co	ivaniagates@yahoo.com
Cal Comm	calcomm@cccwi.com
Cal Electro Inc	sales@calelectroinc.com
Cal Paso Solar, Inc.	admin@calpasosolar.com
cal power aid	razaghakhani@yahoo.com
Cal Roofing Inc.	paul.hein@calroofinginc.com
Cal Solar Works	info@calsolarworks.com
CAL SUN ELECTRIC & SOLAR SYSTEMS	calsunelectric@gmail.com
Cal Valley Solar	terry@calvalleysolar.com
Cal Valley Solar.	terry@calvalleysolar.com
Cal-Power Inc.	gareth@calpower.net
Calafata Construction & Electric, Inc	info@calafata.com
CalCon	calconaptos@aol.com
cali electrical	calielectrical@hotmail.com
Caliber Construction and Restoration Inc	office@gocaliber.com
Calibrated Construction Inc.	calibratedconstruction@gmail.com
California CEC, LP	james.gatlin@cecllc.com
California Coast Builders, Inc.	robr@californiacoastbuilders.com
California Coast Industries	bernie.delacruz@prodigy.net
California Construction and Roofing Inc.	voeltz@calroofers.com
California Energy & Air Quality Services	roger@cespro.net
California Green Designs	contact@ca-green.com
California Green Energy Construction	tom.cagreenenergyconstruction@gmail.com
California Home Solar	yaniv@cahomesolar.com
California Lighting Services, Inc	Calif.LightingServices@yahoo.com
California Platinum Properties Inc.	henryrusselllll@gmail.com
California Power-Save	cat@power-save.com
California Preferred Builders	solaristheanswer@gmail.com
California Premier Roofscapes, Inc.	wes@calprem.com
California Showcase Construction	brian@calshowcase.com
California Solar	info@californiasolar.com
California Solar Concepts	cfo@casolarconcepts.com
California Solar Construction	info@29solar.com
California Solar Electric Company	lars@cal-solar.com
California Solar Electric Systems Inc.	cam@californiasolarelectric.com
California Solar Energy	calsolar@calsolarenergy.com
California Solar Engineering	info@calsolareng.com
California Solar Engineering Inc.	info@calsolareng.com
California Solar Innovations and Electric	csiande@gmail.com
California Solar Innovators Inc.	Jordan@californiasolarinnovators.com
California Solar Solutions	carl@calsolarsolutions.com
California Solar Systems	info@855casolar.com
California State Building Contractors	info@csbcinc.com
California Sun Power	info@casunpower.com
California Sun Systems Inc.	gosolar@csssolar.com
CAM Construction	cam@bizla.rr.com
Cam Electric	timothyweeks@aol.com
Camacho Communications Corporation	j_camacho@camcosolutions.net
Camden Construction	camdenconst@hotmail.com
Cameron Park	cameronparksolar@gmail.com
Campesinos Unidos, Inc.	cuitonicarrillo@sbcglobal.net
Canaday Electric, INC	corky@canadayelectric.com
Candelaria Electric & Solar Inc.	marc@candelariaelectric.com
Capital Aire Systems	casdrady@yahoo.com
Capital City Solar	info@capitalcitysolar.com
Capital City Solar Electric	erika@capitalcitysolar.com
Cardinale's Backhoe And Engineering	cbhoe@yahoo.com
Careys Custom Construction	careyscustomconstruction@yahoo.com
Carl L. Gaw Contracting	carlgaw@yahoo.com
Carlson Solar	info@realgoods.com
Carlton Electrical Construction Inc.	jason@cecinc.co
Carnahan Electric Ltd	john@carnahanelectric.com
CAROLINO CONSTRUCTION CORPORATION	alex@carolinoconstruction.com
Carpenter Construction and Electric	colininca@yahoo.com
Carsey Construction	carseyco@gmail.com
caruzos roofing contractors	marcocaruzo@yahoo.com
Cascade Electrical Contracting Corp.	matt@cascadesolar.net
CASE Enterprises	none@nospam.net
Casey's Electrical	caseys.electrical@gmail.com
Castaneda Electrcal Services	ceslight@gmail.coom
Catalina Solar Energy	CatalinaSolarNrg@yahoo.com
Catamount Electric, Inc.	ted@catelectric.net
Catersolar, Inc.	contact@catersolar.com
Catersolar, Inc.	roy@catersolar.com
Caulder Electric	derekcroberts@gmail.com
Cazimine Construction, Inc	rich@cazimineconstruction.com
CBeyond Solar Corporation	CustomerService@CBeyondSolar.com
CC Builders Inc	Eliezer@elite-solar.com
CC Solar Electric	ccarelli@gmail.com
CCC Inc	crossco@verizon.net
CCK Builders, Inc.	linnertroofing@aol.com
CEGALLIANCE INC	rebates@cega.bz
Celebrity Solar	admin@celebritysolar.us
Celik Engineering Corporation	h.c@celik.net
CenCal Solar	jennifer@cencalsolar.com
Central California Solar Electric	jrector@ccsolar.net
Central Coast Electric	Seasideman@sbcglobal.net
Central Coast Energy Services, Inc.	dennis@energyservices.org
Central Valley Solar	kylehanson@cvsolar.net
Centric Solar Inc	info@centricsolar.com
CENTSUNERGY	centsunergy@gmail.com
Centurion Electric, Inc.	cei1339@att.net
Century Roof & Solar Inc	tonyd@noutilitybill.com
Cerruti Enterprises	pjcerruti@comcast.net
Certified Solar Pros, Inc.	dan@certifiedsolarpros.com
CES Electric	CESjeremy@gmail.com
CES San Diego	admin@cessandiego.com
Cesar Mendoza Electric, Inc.	mendozaelectric04@yahoo.com
Cevista Inc.	dstromnes@cevista.com
CF Construction	chadfisherconstruction@gmail.com
CFO Electric	carlos@cfoelectric.com
CGEC	cagreenenergyconstruction@gmail.com
Chambers Electric, Inc.	jack@chamberselectricinc.com
Champion Electric Inc	trowden@championelec.com
CHANDLERS SOLAR DEVELOPMENT INC	chandlers@gafsolar.com
Chap Inc.	info@aimsolar.us
charles ashmore	cashmore@digitalpath.net
Charles Bailey Custom Builder, Inc.	charliebailey@mac.com
Charles Barnes Construction	cbarnesconst@aol.com
Charles Gulyash	cgulyash@gmail.com
CHICO ELECTRIC	swhaley@chicoelectric.com
chris conn general conctractor	connbuilds@comcast.net
Chris Frye Contracting	chris@capowersave.com
CHRIS MELLOR ELECTRIC	MELLORELECTRIC@GMAIL.COM
Chris' Custom Carpentry	chris@swnl.net
Christianson Roof Company	ryan@christiansonroofing.com
Ciccarello Electric Inc.	VGCiccarello@comcast.net
Cienaga Services, Inc.	cienaga@msn.com
Cinnamon Solar Technology, Inc.	bcinnamon@gmail.com
Cira Energy Inc.	info@ciraenergy.com
Cira Energy, Inc.	don@solarconsultantsllc.com
Cirus Development	steve@modualrlifestyles.com
Cirus Development, Inc	steve@modularlifestyles.com
CitiGreen Inc.	robert.stone@citigreensolar.com
Citizen Green Solutions	Dan@CitizenGreenSolutions.com
City Light & Power, Inc.	WJS@CLPINC.COM
Clancy Construction	tclancy1@hotmail.com
Clarion Electric, Inc.	clarionelectric@surewest.net
Clark Electrical Contractors, Inc	bob@ccielectrical.com
Clarke and Rush Mechanical	solar@clarke-rush.com
Clary Roofing	lonnie.clary@claryroofing.com
Classic Electric & Consulting	ClassicElectric@me.com
Clayborn Contracting Group, Inc.	cmadenford@clayborncontracting.com
Clayton & Son	claytonandsons@wmconnect.com
Clean Air Energy Corp	jerryjames3@gmail.com
Clean Earth Renewable Energy	info@calcleanearth.com
Clean Energy Constructors, LLC	james.gatlin@cecllc.com
Clean Energy of America Group, Inc.	info@cleanenergyofamerica.com
Clean Fuel Connection,Inc.	jmorales@cleanfuelconnection.com
Clean Power Depot INC	info@mslsolar.com
Clean Power Recources, Inc.	dgowey@cleanpowerusa.com
CLEAN POWER SOLUTIONS	robert@cleanpowersolutions.com
Clean Power Systems	Kirk@CleanPowerSystems.com
Clean Rays Energy	mando@cleanraysenergy.com
Clean Rays Energy Inc.	mando@cleanraysenergy.com
Clean Solar	info@cleansolar.com
Clean Works Electric Inc.	brannon@cleanworkselectric.com
CleanFocus Energy Inc	phil@cleanfocusenergy.com
CleanTech Energy Solutions, Inc.	info@go-cleantech.com
Clear Circuit Inc.	mr.perkins14@hotmail.com
Clear Skies Solar, Inc	tom@clearskiessolar.com
Clear Solar Energy	info@goclearsolar.com
Clearview Construction	justa@cvgreenhome.com
clevenger and associates inc	shawn@soladynpower.com
CLOSED	closed@closed.com
CM Electric AV Automations Inc	carlos@cmelectric-pv.com
CMCO Electric	cmcoelectric@gmail.com
CMH Construction, Inc.	chawke@maracordev.com
CMH Partners, Inc.	sunrise805@icloud.com
CN Construction	inspector4492@gmail.com
Coalescent Design & Development	coalescent@sbcglobal.com
Coast Energy Solution	annag@coastdb.com
Coastal Constructors	justincoastalconstructors@gmail.com
Coastal Electrical Solutions	andy@coastalelectricalsolutions.com
Coastal Home Improvement, Inc.	adamh@coastalhomeinc.com
Coastalmoods	ernie@coastalmoods.com
Cobalt Power Systems, Inc.	markb@cobaltpower.com
Code 3 Solutions, Inc	info@code3electrical.com
Codella Solar & Associates Inc.	petercodella2@earthlink.net
Coldwell Construction	coldwellsolar@vfr.net
Coldwell Solar, Inc.	clee@coldwellsolar.com
College of the Redwoods	derek-glavich@redwoods.edu
COLLEGIATE AIR & HEATING	randall.cheetham@gmail.com
Collins Electrical Company, Inc.	cgini@collinselectric.com
Colored Solar	mikem@coloredsolar.com
COMBINED ENERGY INC.	JASONSPEARCEI@GMAIL.COM
Combs Development, Inc.	energyhouse@sbcglobal.net
Comfort King, Inc.	comfortking1992@sbcglobal.net
Comfort Zone Mechanical Air, Inc.	info@comfortzone-air.com
Comm Electric	commelectric@aol.com
Commercial Solar Systems, Inc	ronen@commercialsolarsystems.com
Community Action Partnership of Orange County	aramirez@capoc.org
Community Action Partnership of San Luis Obispo County, Inc.	jmcnamara@capslo.org
Community Resource Project, Inc.	jgraham@cresource.org
Compass Pointe Construction and Remolding	bpotter@californiasunshinesolar.com
Competition Roofing	competitionroofing@yahoo.com
COMPUNET USA LLC	sales@compunetus.com
Con Tec Construction, Inc.	ftbuilditright@gmail.com
Conclusive Corp.	jk@conclusivecorp.com
Conergy Projects, Inc.	licenses@conergy.us
Confidence Builders	dave@webuildsandiego.com
Conley's Greenhouse Manufacturing & Sales	info@conleys.com
Connect Solar & Electric, Inc.	connectsolarelectric@gmail.com
Connector Electric / CE Solar	joe@connectorelectric.com
Constant Solar Power	info@constantsolar.com
Construction Concierge	Salr@constructionconcierge.com
Construction Dynamics	rkline56@sbcglobal.net
Construction Pros Inc.	const.pros@verizon.net
Construction Services Co	lkhollins@hotmail.com
ContactElectric	clarke_erik@yahoo.com
Contempo Construction	dtobias@sunlite-energy.com
CONTI ELECTRIC, INC.	SOLAR@CONTIELECTRIC.COM
Contra Costa Electric, Inc.	Ray_Robertson@emcorgroup.com
Contra Costa Solar	dickweir@yahoo.com
ContractCore	mwilliamson@contractcore.com
Cool Green Solar Fans	Coolgreen@comcast.net
Coon Electric Inc.	coon3@sbcglobal.net
Cooper Controls Inc	eric@coopercontrols.com
Cooper Electric	Electriccoop@sbcglobal.net
Corbin Reeves Construction	ccedervall@gmail.com
Cordell Construction Company	cordell.solar@yahoo.com
Core Energy Systems	contact@coreenergysystems.com
Corner Stone Group Inc.	bpowers@ecotyze.com
CornerStone Construction Solutions (CSCS)	edmond@cscsca.com
Cornerstone RR Construction Inc.	cornerstonerrconstruction1@gmail.com
Corona Electric Solar	hosseik@yahoo.com
Corona Solar	cameron@coronasolar.net
Corporate TwentyOne	corporatetwentyone@gmail.com
corralitos electric service	correlectric@aol.com
Cosmic Solar, Inc.	bahram@cosmicsolar.com
Cossey Inc.	kevin.mmelectric@verizon.net
Cot√© Construction	wpcote@cox.net
Countywide Mechanical Systems	davide@countywidems.com
Cove Electric Inc.	jamest@coveelectric.com
CoySolar	coy@southfacesolarpower.com
Craft Electric Co. Inc.	craftelectriccoinc@sbcglobal.net
Craig A Rogers Construction	dangelo.hvac@yahoo.com
Craig Roof Company, Inc.	paul@craigroof.com
Crane Electric, Inc.	Brucecv@comcast.net
Create Green Energy Inc.	info@creategreenenergy.com
Creative Electric	larry@gocreativeelectric.com
Creative Energy Corporation	davidk@creativeenergy.com
Creative Energy Electric Inc.	pitzek@roadrunner.com
Creo Electric, Inc.	philbyelectrics@sbcglobal.net
Crizer Construction, Inc.	crizerconst@sbcglobal.net
Crown Contracting, Inc.	info@crowncontractingonline.com
Crown Home Center	arlyn@triusa.biz
Cruz Electric Co.	cruzelectric@sbcglobal.net
CSI Electrical Contractors Inc.	energy@csielectric.com
CSI Electrical Contractors, Inc	energy@csielectric.com
CT Electric	ctelectric11@msn.com
CTE inc.	reggie@cte-ca.com
Cucell Inc.	info@cucell.com
Cunningham Electric and Const.	cunningham_electric@comcast.net
Cupertino Electric, Inc.	info@cei.com
Current Electrical Contracting Inc.	info@currentsd.com
Current Integrations	roger@currentintegrations.com
Custom Bilt Metals	aei3@sonic.net
Custom Design And Construction	info@customdesignandconstruction.com
Custom Solar	customsolar@yahoo.com
Custom Touch Electric	Jason@customtouchelectric.com
CWD Loma, Inc.	chad@calprem.com
Cyrus Solar Inc.	s.namiranian@cyrus-solar.com
D C Design & Construction Services	dpdcflower@aim.com
D F H Electric, Inc	dharbaugh@san.rr.com
D&L Electrical	seand@davidson-electric.com
D-Jay's Electric	djayselectric@sbcglobal.net
D.E.I Electric, Inc	vern@deielectricandsolar.com
D.E.I. ELECTRIC INC	deielectricinc@gmail.com
D.M. Alegre Construction Inc	dmaci@caldsl.net
D.P. Door Company, Inc.	dpfloater@aol.com
D.R. Brown Company	dbrown@solaruniverse.com
D03 Inc.	smt0077@gmail.com
Daedalus Solar Systems Inc.	jereclark9@gmail.com
Dailan D. Electic	kvu360@gmail.com
Daily Electric	billdaily@verizon.net
Dajing Solar Usa Inc.	kevin@dajingsolarusa.com
Dale Meyer	dale.meyer5@sbcglobal.net
Dan Garibay	garibay.construction@yahoo.com
Dan O'Connor Electric	ocelectric@mlode.com
Daniel A Willms Construction	dwillms@gte.net
Daniel Fraiman Construction	dan@danielfraimanconstruction.com
Daniel's Electrical Construction Co., Inc.	jeff@danielselectric.com
Danny Letner Inc.	dolson@letner.com
Darrah Electric	scott.darrahelectric@yahoo.com
Darren Lee Image Interior LLC	greenurbansf2010@gmail.com
DARROW ELECTRIC	darrow@darrowelectric.com
Datacom Electrical and Solar	pasknet@gmail.com
Dave Bettis Construction	dave@davebettisconstruction.com
Dave Figone Construction	DFIGONE@HOTMAIL.COM
Dave Moyer Solar	moyers@citlink.net
Dave Partain	dekelec@mindspring.com
David Bruce Construction	davidbruce88@gmail.com
David Crowell Electric, Inc.	dave@davidcrowellelectric.com
David Gerrard Electric	annie@gerrardelectric.com
David H. Neilson Construction Inc	neilsonconstruction@roadrunner.com
David Hanson Construction	david@davidhansonconstruction.com
David M Polanco	david.polanco@sbcglobal.net
David Panscik Electrical	david@solar209.com
David Starrett Construction	dscwxwork@gmail.com
Davids Equipment	jeremycooley1@gmail.com
DAY Construction	day4849@aol.com
Day One Solar, Inc.	info@day1solar.com
Day Solar	mgonzales@daysolarpower.com
DBR Energy Engineering, Inc.	info@dbrenergy.com
DC Solar Electric Inc.	lstevens@dcsolarsolutions.com
DC Solar Solutions MFG, Inc	paulette@dcsolarsolutionsmfg.com
DCD Electric, Inc	fcarr@dcdelectric.com
De Oliveira Electric Inc.	deoliveiraelect@aol.com
Dean Brown Construction	dean@deanbrownsolar.com
Dean Clark Electric	deanclarkinc@aol.com
Deep Technology	info@dtsolarsystems.com
Definitive	bmiller@definitivetheater.com
defreitas construction	defreitasconstruction@msn.com
DEI ELECTRIC INC	VERN@DEIELECTRICANDSOLAR.COM
Del Sol Energy Solutions Inc.	tjones@delsolsolar.com
Del Sol NRG INC	info@delsolnrg.com
Delbert Howards Building, Inc.	del@delberthowardsbuilding.com
Delta Solar Electric Inc.	van@deltasolarelectric.com
DePinho Roofing Inc.	nelson@depinhoroofing.com
Derek Ehinger Electric	derekelectric_nikki@yahoo.com
Desert Energy Solutions	dsrtnrgy@aol.com
Desert Power Inc.	earlschmid@desertpowerinc.com
Desert Solar Electric	desertsolarelec@aol.com
Desert Solar, Inc.	admin@desertsolar.org
Design Integration Group, Inc.	info@digservices.com
Design Lighting Inc.	mlackna@gmail.com
Designer Engineering & Contracting Inc.	raffi@designer-usa.com
Devert Energy	info@devertenergy.com
DF Electric	danferialdi@gmail.com
DFRS	dfrs@surewest.net
DH Synergetech LLC	synergetech@ymail.com
Diablo Integrated Construction & Solar	JMoser@DiabloICS.com
Diablo Solar Services, Inc	bryan@diablosolar.com
Diablobuilders	Diablobuilders@live.com
Diamond Ridge Roofing, Inc.	drrinc@baik.rr.com
Diaz Construction	dconstruction_97@yahoo.com
Dick Emard Electric, Inc	ilbra@emardsolar.com
Dick Jordan Construction	djsolar@starband.net
Dick Jordan Construction	djsolar@mcn.org
Dick Wagner Solar Savings	dick@dickwagner.com
Dickinson Energy Solutions	dhac1986@yahoo.com
Dicksons Inc.	info@dicksonsinc.com
DigAbode, Inc	kwilliams@digabode.com
Direct AC & Solar	directac@sti.net
Distributed Clean Power	dannyzgold@gmail.com
Diversified Builders	kenbuilds4u@hotmail.com
Diversified Electrical Systems	timhouston03@gmail.com
Divine Electrical Services Inc.	kzacharda@gmail.com
Divine Power USA	dave@divinepowerusa.com
Divine Solar	info@divinesolar.net
divisionSF	matt@divisionsf.com
Dj Solar Inc.	kevin@dajingsolarusa.com
DJH Construction Inc	info@djhconstruction.com
DJH Construction, Inc.	djhconstruction@cox.net
DK Electrical Contractors, Inc.	dkelectric@att.net
DL Energy	bburson@dlenergy.net
DLP Electric & Lighting	chrisb@dlpquality.com
DMA Builders	camposleonardo@sbcglobal.net
DMC Electric	dmcelectric@att.net
Dmi Construction Inc	sophia.s@dmicoandsolar.com
DMJ Electric	olsendmike@gmail.com
DMR Electric	info@dmrelectric.com
Doble & Son Custom Homes Inc	pauldoble@me.com
DOD Construction LTD	derrickd@dodconstruction.com
Dodson Bros Roofing, Inc.	dbrinc@clearwire.net
DON R WATSON	superiormachine123@gmail.com
Donald P Dick Air Conditioning, Inc	dave@mrcool4ac.com
Dondero & Son Electric	ssugreentim@gmail.com
donkey solar	donkeysarefunny@aol.com
Dorado Construction, Inc.	H1239@aol.com
Dority Roofing and Solar	dorityroofing@sbcglobal.net
Double D Electric	dtinlin@yahoo.com
Douglas D Drube	ddrube@charterinternet.com
Douglas D Drube	ddrube@charterinternet.com
Douglas Doherty Electric And Solar	doug@douglasdohertyelectric.com
Douglas F. Elliott Electrical Contractor	watertec_net@yahoo.com
Douglas G. Milan	dlmilan@surewest.net
Down to Earth Solar	downtoearthsolar@comcast.net
Dr. Kilowatt	service@drkilowatt.com
DR. SPARKS	warren.shook@gmail.com
Dragon Solar, Inc	Dragonsolar888@gmail.com
DRE Power and Cabling Contractors, Inc	dave@powerandcabling.com
Dream Maker Builders	meital@dreamdesignbuilders.com
DRH Electrical, Inc.	dan@drhelectrical.com
DRI Energy	energy@dricompanies.com
Driven Electric, Inc.	drivenelectric@aol.com
DTS Electric, Inc.	daryl@dtselectric.com
DUFFY CONSTRUCTION	patriduff@aol.com
Duk J Corporation	info@samwongroup.com
Dunbar Electric Sign Company	trishdunbar@cityneonsigns.com
Dunham Roofing, Inc.	dunhamroofinginc@aol.com
Dunrite Construction	dunrite@sbcglobal.net
Durant Construction	durantconstruction@comcast.net
DW August Company	DUANE@AUGUSTCOMPANY.COM
Dybdahl Electric	erik.dybdahl@comcast.net
Dykes Construction Corp.	dykesconstruction@roadrunner.com
Dynalectric Comapny	briel@dyna-sd.com
Dynamic Home Performance INC	dynamichomeperformance@gmail.com
E Z Electric	szachman@ez-electric.com
E&G ELECTRICAL INNOVATIONS	gerry@egelectricalinnovations.com
E.E. Electric, Inc.	mike@ee-electric.net
E.L.HELTON CONTRACTING	info@elheltoncontracting.com
Eagle Energy Electric Co.	drnipper@sbcglobal.net
Eagle mountain solar plumbing and heating	bigbearplumber2@hotmail.com
Eagle Systems International	thomas@synergycompanies.org
Earth Electric Inc	info@earth-electric.com
EarthStar Electric	daniel@earthstarelectric.com
East Bay Electric	joe@eastbayelectric.com
Easton Pacific (E.P.C.C. Inc.)	energy@eastonpacific.com
Easy Solar Corp	info@poteresolar.com
Eberhard	bmowatt@eberhardco.com
ECI Engineered Fire Systems	bluewatersolutions@sbclgobal.net
Eckard Roofing Inc	scott@eckardroofing.com
Ecklund Construction	amrit@ambassadorenergy.com
Eclipse Energy	info@eclipseNRG.com
Eco Construction Solutions	brent@ecocs.com
Eco Energy Global Consulting, Inc	admin@accendsolar.com
Eco One Energy	eugene@ecooneenergy.com
Eco Smart Homes & Building	ecosmarthome.building@yahoo.com
ECO SOLAR INC	MIKE@ECOSOLARNOW.COM
Eco Solar, Inc.	info@EcoSolarNow.com
EcoAdvantage Power Inc	windy-1@live.com
EcoConsultants	sales@ecoconsultants.com
ECOGREEN CONTRACTORS	ecogreencontractors@gmail.com
ECOMAC Electric, Inc.	ecomac@live.com
Econo Air Inc.	greg@econoair.com
Econo West, Inc.	econowesthvac@aol.com
Econo-West Inc.	econowesthvac@aol.com
Economic Energy Solutions, Inc.	gregg@econenergy.us
EcoPlexus Inc.	erikstuebe@ecoplexus.com
EcoPlexus, Inc.	info@ecoplexus.com
ecoSolargy inc.	info@ecosolargy.com
Ecovations Lifestyle	info@ecovations.com
Ecovations Lifestyle Inc	info@ecovations.com
ECS Design, Inc.	ECSDesign@hotmail.com
ED Electric Co.	edvielectric@yahoo.com
Ed-lectric	edlectric@sbcglobal.net
EDI LIGHTING	richards.daniel.j@gmail.com
Edison Electric and Solar	Chris@edisonpro.net
EESC Inc	pjett@enable-energy.com
Effective Electric	effectiveelec@hotmail.com
Efficient Building Enterprises	CSnyder@efficientbuilds.com
Efficient Energy Concepts	eec@digitallpath.net
Efficient Energy Distribution Inc	info@efficientenergydistributioninc.com
Efficient Solutions	efficientsolutionsgc@gmail.com
EFS West	jay.persaud@efswest.com
EG Electric	eg-electric@live.com
Egan Electric	philip@eganelectric.com
Eiamia Inc. (Solar & Construction)	kuljit_khunkhun@hotmail.com
Ekim Builders Inc.	mikecontreras@san.rr.com
El Camino Electric Inc.	elcaminoelectricbt@att.net
Eldridge Electric and Son, Inc.	chris@eldridgeelectric.com
Electri-com, Inc.	info@electricom.net
Electric Electric	david@arcboards.com
Electric Motor Shop Inc.	ray.keith@electricmotorshop.com
Electric Pink, Inc.	electricpinkinc@yahoo.com
Electric Pro	TheElectricPro@yahoo.com
Electric Service & Supply Co.	gary@esscoelectric.com
Electric Stars	fred.cherrick@electricstars.com
Electric Tech Construction, Inc.	tomb@etech-inc.net
Electric-Man	electricman@earthlink.net
ELECTRICAL CONCEPTS INC	LOPEZELECTRIC1@AOL.COM
Electrical Design & Motor Control, Inc.	kjr@edmci.com
Electrical Design Lighting, Inc	edlmejia@yahoo.com
Electrical Distribution Services Inc.	info@edsi-usa.net
Electrical Dynamics	edynamics101@gmail.com
Electrical Service Plus	bhernandez@electricalserviceplus.com
Electrical Solar Solutions	phamerski@charter.net
ELECTRICAL UNLIMITED INC	e.unlimited.solar@gmail.com
ElectriCare, Inc.	solar@electricare.com
Electricraft, Inc.	jtreder@electricraftinc.com
Electro Construction Corp	john@electroconstruction.com
Electro Illumination & design Inc.	electrostan@msn.com
Electron Connection, Inc	bob-o@electronconnection.com
Electronic Processing Technologies, LLC	sales@electroprotech.com
Electronic Telemetry & Power Conditioning	support@etc-power.com
Element Electric Inc.	ALOFFGREN@ELEMENTELECTRIC.COM
Element Power Systems, Inc.	info@elementpowerinc.com
Element Renewable Energy Inc.	admin@elementrenewable.com
Element Renewable Energy, Inc.	admin@elementrenewable.com
Elight Electric	elightelectric@gmail.com
Elite Electric Inc.	carl@elite-electricinc.com
Elite Home Energy	bill@elitehomeenergy.com
elite hvac	airman@ca.rr.com
Elite Remodel & Renovations Inc.	eliteremodel@hotmail.com
Elite Roofing	jonutzelite@sbcglobal.net
Elite Solar	kshort@elitesolarca.com
Elkco Electric	eskarjola@frontiernet.net
Ellison Construction	ecoc.sellison@hotmail.com
Ellison's Construction	ecoc.sellison@hotmail.com
Emard's EHT	aspen@solaruniverse.com
Emerald Green Engineering, Inc	kshariff@solaruniverse.com
Emerald Kings Inc.	emeraldkingsca@me.com
Emm Gee Developers and Builders Inc	mukeshgupta59@yahoo.com
Empire Solar Solutions Inc.	info@empiresolar.com
Empowered Energy Solutions Inc	info@empoweredenergysolutions.com
Empyrean Electric	rich@empyreanelectric.com
enCompass Builders	encompassbuilders@yahoo.com
Endelos Energy, Inc.	jbernardino@endelosenergy.com
Endless Solar Electric	neal@myendlesssolar.com
Ener-Tech Construction Services	ener-tech.cs@hotmail.com
Enercomm Electric Inc.	danf42@yahoo.com
Energize The Experience Inc.	mrsimonsez@gmail.com
Energy Acumen Corp.	rajiv@energyacumen.com
Energy Balance Engineering	elmer_sg@yahoo.com
Energy Concepts	jason@energyconceptsfresno.com
Energy Efficiency Solar	sales@acroenergy.com
Energy Efficiency Solar	sales@acroenergy.com
Energy Efficiently	mike@energyefficiently.com
ENERGY ENTERPRISES USA INC	info@energyenterprisesusa.com
Energy Equity	brian@ncsr.com
Energy Independence, INC	Info@ei-us.com
Energy Industries California Corporation	jessica.gohss@energy-industries.com
Energy Management Solutions	john@emsystems.net
Energy Plus	eric@energyplusair.com
Energy Pros, Inc.	bob@energypros.net
Energy Protection Systems Group, Inc.	info@epsnow.com
Energy Recovery Group, LLC	mikecgroup@comcast.net
Energy Saving Pros Construction, Inc.	shad@energysavingpros.com
Energy Solar	don@energysolarnow.com
Energy Stars Construction	energystarsconstruction@gmail.com
EnergyMasters	embhoovero@gmail.com
EnergyWize Building Solutions	info@energywizebuilding.com
Enerlon	info@enerlon.com
Enfield Electric	dougenfield@msn.com
Engelbach Electric, Inc.	jon@engelbachelectric.com
Engler Construction Co.	englerconstruction@sbcglobal.net
Enriched Energy Solution	Andrewnroche@gmail.com
Enterprise Electrical Services	enterpriseelectrical@yahoo.com
Enviro Construction Concepts	info@enviroconstructionconcepts.com
EnviroAssets, Inc.	mharrison@enviroassets.com
Envirodiscount.com	smookers_1@hotmail.com
Environmental Assessment and Remediation Management, Inc.	rpendurthi@earmanagement.com
Environmental Systems Inc.	tjkay@esite.net
Envirotech Global Inc.	davidw12348@aol.com
Envision Solar International, Inc.	Info@EnvisionSolar.com
Epic Energy	alambert@theepichome.com
Epic Power Systems Inc	epicpowersystemsinc@gmail.com
Epic Solar Inc.	joe@epic-solar.com
Epica, Inc.	fhumbert@solaruniverse.com
Eric Welter Electric	eric@welterelectric.com
Eric Wendt Construction, Inc	ewendtconstinc@yahoo.com
Ericksen Electric	vwe@comcast.net
Erickson Construction Company,Inc.	contact@eccnc.com
Ericson Solar	sunpowerr@sbcglobal.net
Eriksson	aaron.eriksson@gmail.com
Ernie Mauro Electric	bigern969@aol.com
ES Electrical Construction Inc	info@eselectricalinc.com
ESCEX Sustainable Energy	jaycutting@escexusa.com
Eshone Electric, Inc	yoel@eshone-energy.com
Eshone Energy Inc	yoel@eshone-energy.com
Espie Electric Company	espie12@verizon.net
Estero Bay Sustainable Solutions	Brian@eb-ss.com
ETI Services, Inc.	nir@etiservicesinc.com
ETI Services, Inc.	ezra@etiservicesinc.com
Evans Energy Systems	revans1212@gmail.com
Evergen Systems Inc	s.sidhu@evergen.us
Evergreen Energy Solutions	luis@evergreensolarsolutions.com
Evergreen Solar Solutions	luis@evergreensolarsolutions.com
Everyday Communications Corp.	info@everydayenergy.us
Evolution Electric	evolutionelec@yahoo.com
Evolution Electric & Solar	evolutionelectric@cox.net
Evolve Builders	darrellswensen@gmail.com
Excel Electric & Automation	tom@energyandautomation.net
Excel Electric Inc.	solar@callexcelelectric.com
Excel Solar & Electric, Inc.	excelsolar@sbcglobal.net
Executive Roofing	dave.berke@sbcglobal.net
expedite electrical co	expeditedsolar@gmail.com
Express Electric Service Co.	explectic@sbcglobal.net
Exsolarent Energy Group, Inc.	sowels@exsolarentenergygroup.com
Extreme Energy Solutions	robdavey@extremeenergysolutions.biz
Extreme Make Overs.Inc	royvcouvertier@yahoo.com
F. Rodgers Corporation	gvetter@frodgers.com
Facilities Dynamics, Inc.	dboy@facilities-dynamics.us
Faith Com, Inc.	vendorinfo@fcimgt.com
Faith Technologies, Inc.	jennifer.hazaert@faithtechnologies.com
fake company	fake@aox.com
Fallbrook Irrigation, Inc.	gpstar@pipesupply.com
Famand Inc.	ejordan@ies-hvac.com
Farpointe	kkoch@farpointe.net
FE-FA Inc.	fefainc@gmail.com
Feather River Solar Electric	frenergy@psln.com
FenSys Ltd.	kfenske@fensys.com
Ferreira Construction Company	bpensick@ferreiraconstruction.com
Fidelity Roof Company	kenwhite@fidelityroof.com
Finish Team	jeremycooley1@gmail.com
Fire wire systems inc	Artmolina@firewiresystems.com
First American Solar	Hello@FirstAmericanSolar.com
First Electric	dontobias@ymail.com
First Electric Systems INC	FESseong@gmail.com
First Pick Builders	firstpickbuilders@mchsi.com
Fisher Electric and Solar	fisherelectric@netzero.com
Fisher Electric, Inc.	info@fisherelectricinc.com
Fitzpatric Elctric, Inc.	fitzelectric1@yahoo.com
Five Cities Inc.	mikeauto@yahoo.com
Flagg Building Improvements	dave@flaggbuilding.com
Flexible Building System,LLC	travis12r@yahoo.com
Florentin Construction	florentinconstruction@gmail.com
Focus	manzanick@gmail.com
Foothill Electric, Inc.	foothillelectric@att.net
Forsberg Construction Inc.	fcicontracting@sbcglobal.net
Forterre, Inc.	jcharmasson@forterre.com
forward construction	tforward11@yahoo.com
Forward Electric	shawnrichardson05@yahoo.com
Foshay Electric Co., Inc.	hector@foshayelectric.com
Four Phase Energy Corporation	info@fourphaseenergy.com
FPV Electrical Company	ferial@fpvelectrical.com
Frank A Manqueros	Frank@americansolar.ca
Frank Lanser Electrical & General Contractor	frank@franklanser.com
Fred Mikanovic Construction	fred@intes.com
Frederick Richardson Construction	mail4richardson@gmail.com
FREE ENERGY CONSTRUCTION INC	info@ferisolar.com
Freedom Solar, Inc.	Info@FreedomSolar.net
FreedomHeating, Inc.	Info@FreedomHeating.com
Fresco Solar	sean@frescosolar.com
Frontier Solar Inc.	info@frontiersolarinc.com
Frost Electric	frost-electric@hotmail.com
Frost Electric Inc.	dan@danfrostelectric.com
Fry Fire and Electric, Inc.	rickf@ecosunusa.com
FTR International Inc.	estimating@ftrintlinc.com
full phase electric	fullphaseelectric@gmail.com
Funk E. Inc.	robert@funkeinc.com
Fuse Solar	isaac.freed@fusesolar.com
Future Electric Construction and Automation, Inc	future_electric@msn.com
Future Energy Corporation	jdurst@energysavers.com
Future Energy Now	sales@fesolarnow.com
FV Electrical Services	fvaldehuesa@fvvelectric.com
G and A Electric	gandaelectric@yahoo.com
G M Electric	greg@murrieta_electric.com
G T Cox Electric	gtcoxelectric@charter.net
G&G Electric	GGelectric@ymail.com
G. D. MacKenzie & Company	g.d.mac@sbcglobal.net
G.A Mundia Inc.	gamundiainc@cox.net
G.H. Remodeling, Inc.	brandonc.sullivan@yahoo.com
GA Technical Services, Inc	gats@gatechservices.com
Gabriel Alley	tonyalley00@yahoo.com
Gabriel Alley Heating & Air	gabrielalleyhp@gmail.com
Gaia Energy Systems	kate@gaiaproductions.com
Galileo Solar	kbryc08@gmail.com
Ganesh Works, Inc	office@ganeshworks.com
Garcia & Garcia Affordable Roofing Inc.	pam@affordableroofing.com
Garcia & Garcia Affordable Roofing, Inc	j@affordablesolarroofs.com
Garcia&Sons Home Improvement	Glawrencebk@aol.com
Garco Inc.	garciaconstruction@comcast.net
Garland Perry Enterprises, Inc	garland@661solarelectric.com
Garrahan Electric Inc	nickc@garrahanelectric.net
Garvey Roofing Inc.	garveyroofing@yahoo.com
Gary Rush	garyrush@wildblue.net
Garza's Air Conditioning & Heating Inc.	garza4068@sbcglobal.net
Gaspers Electric	grandcharger@hotmail.com
gatewood heating air and electric,inc.	gatewoodhvac@hub3.net
GCI SOLAR	melissa@gcisolar.com
Gecko Logic-USA DBA	jeremy.schurman@geckologic-usa.com
Gehrlicher Solar America Corp	eric.carter@gehrlicher.com
Geiser Electrical Contracting, Inc	che@geiserelectric.com
Gene McCormick construction	genem@solrease.com
General Control Systems, Inc	wrobertcarey@yahoo.com
General Electric International, Inc	keith.gossman@ge.com
General Engineering Tectonics	gkroll@engineeringcontractor.com
General Environmental Management Services, Inc	joejgems@uia.net
Generation 819	sales@gen819.com
Genesis Electrical Inc.	raymondwashington169@yahoo.com
Genesis Energy Solutions	contact@genesisca.com
Genesis Homeworks Inc.	roger@genesisstoneworks.com
Genesis Power Systems	genesispowersystems@yahoo.com
GENTEC Services, Inc.	jscerbo@gentecservices.com
GEO CONSTRUCTION	georgermapp@gmail.com
Geo Solar Inc	george@alternative-elec.com
George Nikolas & sons	gwnikolas@aol.com
George Reed , Inc.	ron.foust@georgereed.com
Get Green Remodeling, Inc.	christian@get-greenremodeling.com
Ghigos Energy, Inc.	info@ghigosenergy.com
GI Energy	theoc@gienergyus.com
GIA Electrical and Solar Inc	john@giaesolar.com
GigaWatt Inc	info@gogreensolar.com
Gigawatt, Inc.	sales@gogreensolar.com
Gilbert Lee Construction, Inc.	info@gilbertleeconstruction.com
Giles Construction	sgilesac@aol.com
Gilmore Services Inc	johng@gilmoreinc.com
Gilmore Services, Inc.	service@gilmoreinc.com
Glaeser Builders INc	tonyw@glaeserbuilders.com
Glass Creek Inc.	rob@demandcharge.com
Glenmar Green Energy Solutions	glenmarsolar@gmail.com
GLK Construction, Inc	gkeller@sunbestsolar.com
Global One Energy LLC	singh@globaloneenergyllc.com
Global Power Group, Inc.	smartorana@gpgpower.com
Global Resource Options	info@grosolar.com
GM Renovations, Inc	greg@gmrenovationsco.com
GMC Contracting Inc.	geoff@gmccontracting.com
Go Solar Cooperative, Inc	kelly@gosolar.coop
Go US Solar	dulanyh@gmail.com
Goforth Designs	joeg@mcn.org
Gold Coast Electric Services	Jose@831getpowr.com
Gold Coast Electric Services Inc.	Jose@831getpowr.com
Gold Coast Sound Inc	rod@goldcoastsound.com
Gold Electric Inc.	goldelec@goldrush.com
Golden Gate Green Finance, Inc.	admin@goldengatepower.com
Golden Gate Photovoltaic	gregstarke49@gmail.com
Golden State Power	Gabriel@GoldenStatePower.com
Golden State Solar Power	Joseph@GoldenStatePower.com
Golden Sun Technology Inc.	johanna@amgssolar.com
Golden West Energy	scott@goldenwestenergy.com
GoldenBridge Development Corp	jaipal@gbdevelop.com
Gomez Heating and Air Conditioning, Inc	victoramone14@hotmail.com
Good Energy Renewables Inc.	aaron@goodenergyrenewables.com
Good Seed Community Development Corp	jthompson@goodseedcdc.org
Goodman Construction and Electrical Inc.	rick@webuild.net
Goodman Services	peter@goodmanservices.biz
GoSimpleSolar by Semper Fidelis Construction Inc	mark@GoSimpleSolar.com
Got Watts Electric, Inc.	info@gotwattselectric.com
Gould Electric	russthurman@gouldelect.com
GP Development inc	gperkins@gpdevelopmentcorp.com
GP Electric	gar57@sbcglobal.net
Graham Porter Construction, Inc	gporterconstruction@gmail.com
Graham Solar Systems Inc.	grahamsolarsystems@yahoo.com
Grand American Industries	jason@cybergade.com
Granite Bay Energy Group, Inc.	info@granitebayenergy.com
Granite Construction Company	Sean.Kilgrow@gcinc.com
Grass Valley Air Conditioning	gvac@pacbell.net
Gray Gamwell Corp	fgamwell@pcmla.com
Gray Gamwell Corporation	irishbull0@aol.com
Gray solar, inc.	Sales@graysolar.com
Graziano Custom Roofing	ed@grazianoroofing.com
greatful sun	arancollier@gmail.com
Green Air Heating and Air Conditioning	greenair@gogreenair.net
Green America Construction	greenamerica@wildblue.net
Green Build Education Group	brsassociates@comcast.net
Green Building Squared, Inc	gb2@greenbuildingsquared.com
Green Building Technologies	cyates@greenmc.com
GREEN CAT SOLAR ELECTRIC	contact@greencatsolar.com
Green Concept Solutions	xpdite2014@gmail.com
Green Conception, Inc.	info@greenconception.com
Green Construction Service	jenni@greenconstructionservice.com
Green Contractors, Inc.	info@greencontractorsinc.com
Green Convergence	Info@GreenConvergence.com
Green Dragon Solar	chris@greendragonsolar.com
Green Earth Engineering Corporation	jdelavega@greenearth-usa.com
Green Earth Solar	ron.whipple@gmail.com
Green Electric Solar Solutions	cort@greenelectricsolarsolutions.com
Green Electric Solutions	jf@greenelectricsolutions.com
Green Energy Solutions Inc.	dave@patriotroofing.com
Green Energy Solutions Inc.	Oscar@green-e-solutions.com
Green Energy Solutions, Inc.	reception@wearepatriot.com
Green Engineering Solar Corporation	info@greenengineeringsolar.com
Green Home Technology	lawlisscorp@gmail.com
Green Lantern Electric	raymond.villegas.jr@gmail.com
Green Light Electric	greenlightelectric@gmail.com
Green Movement Builders	info@greenmovementbuilders.com
Green Nation Direct	gndhomeimprovement@gmail.com
Green NRG	ykimhi2@gmail.com
Green Planet Solar	DMcNell@GreenPlanet-Solar.com
Green Power Construction	aaron@greenpowertoday.net
Green Power Installers, Inc	barukh@greenpowerinstallers.com
Green Rev Energy	derek@greenrevenergy.com
Green Roof Electric	swillis@greenroofelectric.com
Green Roofing Solutions, Inc.	greenroofingsolutions81@yahoo.com
Green Solar Corporation	erickgreen@cox.net
Green solar power inc	Info@greensolarpowerinc.com
Green Solar Solutions,Inc.	greensolarsolutions@yahoo.com
Green Solar Systems, Inc.	sales@greensolarinc.com
Green Source Solutions, LLC	greensourcesolution@gmail.com
Green Stock Solar	dpeterson@greenstocksolar.com
Green Total Solutions	dcoller@greentotalsolutions.com
Green Valley Corporation	jnickell@barryswensonbuilder.com
Green Volt Energy	jon@greenvoltenergyca.com
Green Voltage Group, Inc.	cat@capowersave.com
Green Wave Solutions	jim@greenwavesolutions.com
Green World Services Inc.	brian@greenworldinc.net
Green-PowerSolutions.Com	erwinrubio@green-powersolutions.com
Green-Tech Environmental Services	info@green-tech-environmental.com
Green-Tech Environmental Services Inc.	info@green-tech-environmental.com
GreenBuild Energy	sales@greenbuildenergy.com
GreenCal Solar	andrew@greencalsolar.com
GreenCoast Enterprises, Inc.	linda@greencoastelectric.info
Greene Electrical	RICK.GREENE@MAIL.COM
Greener Fitting	info@greenerfitting.com
Greenergy Incorporated	gcabrera@greenergysolar.com
GreenHouse Energy	joec@greenhouseenergy.com
Greenify	a.noriega@greenifyhome.com
GreenLeaf Solar Salution	nedirbey@yahoo.com
GreenLife Solar Electric, Incorporated	cliebel@greenlifesp.com
Greenlight Electric Corp.	peterp@greenlightelec.com
Greenovation	randallapaul@yahoo.com
GREENspace Design & Construction, Inc.	livefree2@att.net
GreenSun Construction	greensunconstruction@gmail.com
Greenway Solar Electric, Inc.	mikem@greenway-solar.com
GreenWire Technologies, Inc.	kevin.robertson@greenwiretechnologies.com
Greenwired	daniel@greenwired.net
Greenwise Solutions	soheil@greenwise-solutions.com
Greenwise Solutions Inc.	info@greenwise-solutions.com
Greg Bellows Plumbing Inc.	jason@bellowsservice.com
Greg Martin Electric	greg@gregmartinelectric.com
Greg Meenderink	gregmeenderink@yahoo.com
Greg Shaw Construction	ejw@lccs.net
Greg Tomsik Construction	gdtomsik@jett.net
Gregg Todd Hamilton	gregthamilton@energyoptions-wind.com
Gregory Heitzler Design	greg@ghdsolar.com
GRID Alternatives	info@gridalternatives.org
Grid Remedies, Inc.	dlee@gridremedies.com
GridPoint, Inc.	mwhite@gridpoint.com
Griffin Molinari Building Construction, Inc	eamon@gmbcinc.com
Grimes Green building services, Inc	norman@connollyhvac.com
Ground Up Builders	info@groundupbuilders.com
Grounded Electric	groundedelectric@cox.net
GSE SOLAR SYSTEMS	sales@gsesolar.com
GTi Solar Builders INC.	david@gtisolar.com
GTS Construction & Development, Inc.	gtsayler@softcom.net
Guardian Technical Services, Inc.	myra@guardiantechservices.com
Guasti Construction, Inc	guasticonst@aol.com
GWMarbuilders, Inc.	marbuilders@earthlink.net
H-Ion Solar Inc.	hionsolar@aol.com
H.J. Vast Electric Inc.	Henry@hjvast.com
Haase Energy Systems, Inc.	hesco@clearwire.net
Hail's Plumbing Hydronic & Solar Inc.	jchail214@yahoo.com
Hal Hays Construction, Inc.	ecabral@halhays.com
Halcyon Renewables, Inc	solar@HalcyonSolar.com
Halo Electric	HaloElectric@2HKC.com
Hamann Construction	phoebe@hamannco.com
hankins electrical contracting	brannan@hankinselectrical.com
Hanley Construction, Inc	jim@hanleyco.com
hardy Diesel and Equipment	kim@hardysolar.com
Harmony Air	harmonyair@gmail.com
Harness the Power Inc.	harnessthepower@hughes.net
Harney Lighting & Electric	info@harneyelectric.com
Harrell Electrical Services	cameron.harrell@hes-icr.com
Hase Electrical Services Inc	Haseelec@aol.com
HassingerSolarSystems	sales@markhassinger.com
HD Builders	rickduckart@hdbuilders.net
Healdsburg Solar	Robert@HealdsburgSolar.com
Heating & Air Technology of CA	manfred@heating-airtechofca.com
Helbig Lighting Design & Electric	Helbiglighting@att.net
Helio Construction	sales@helio-construction.com
Heliofarm	aditya@heliofarm.com
Heliofarm LLC	info@heliofarm.com
HelioPower, Inc	info@heliopower.com
HelioTek Corporation	nwatson@heliotekcorp.com
Helix Electric, Inc	afarthing@helixelectric.com
HEMC Environmental Management Corp.	jh@hemc.us
Henry J. Brook	henrybrook@comcast.net
Henry John Brook	henrybrook@comcast.net
Hensel Construction Company	mhensel@qualitysolarsolutions.com
Herca Solar Inc	hector.castellon@hercasolar.com
Herca Solar, Inc.	david.vega@hercasolar.com
Heritage Solar Inc.	dennis@heritagesolar.com
Heyermann Green Energy, Inc.	chere@heyermanngreenenergy.com
Hi Desert Industrial Electric	HDIE@verizon.net
Hi Teck	hiteckconstruction@yahoo.com
Hi-Tec Solar and Construction	kentrappen@hotmail.com
Hi-Tech Roofing Services	hitechroofing@gmail.com
Hi-Tech Solar	hitechsolar@yahoo.com
Higgins Electric Inc	rhett@higginselectricinc.com
High Definition Solar	info@highdefinitionsolar.comm
High Light Electric Inc	estimating@hleincusa.com
High Output Electric	artypalmer@charter.net
High Point Builders, Inc	mike@hpbconstruction.com
HIGH- TECH SOLUTIONS & SERVICES INC	htsscorporation@yahoo.com
Highlight Solar	info@highlightsolar.com
Highpoint solar	sc000ter@hotmail.com
hiram construction	hiramconstruction@gmail.com
HiTec Solar and Construction	kentrappen@hotmail.com
HLV Electric Co.	stong@solarsolutions4u.com
HMH Builders	dhigginsjr@hmh.com
HMW Development Inc	walter@hmwdevelopment.com
HODGES ELECTRIC INC	roger@hodgeselectric.us
Hodne Construction, Inc.	HodneConstruction@socal.rr.com
Hoes Engineering, Inc.	Charles_Hoes@Hoes-Eng.com
Hofalar Electric	dhofalar@gmail.com
Hoffman Construction	Shawn@HoffmanConstructionInc.com
Hoffman Construction Inc.	Shawn@HoffmanConstructionInc.com
HOFFMAN ENGINEERING & PIPLINE	maryhoffmanRE@gmail.com
Holland Construction & Design	holland40099@yahoo.com
Hollywood Electricians	Richardleemiller@gmail.com
Holt Electric, Inc.	mikeh@holtelectric.net
Home Energy Systems	ross@hessolar.com
Home Networks & Electrical	admin@homent.com
Home Performance Matters	info@homeperformancematters.com
Home Star Energy and Solar Inc.	dyatsko@homestarenergyandsolar.com
Home Tight Inc.	mike@hometightinc.com
Home Unplugged	sandpeople_1@yahoo.com
Home-Teck	Rolf@Home-Teck.com
Homegrown Energy Solutions LLC	info@homegrownenergysolutions.com
Homestar Builders Inc.	homestarbuilders.info@gmail.com
HomeStar Custom Homes	Festifest@aol.com
Homo Habilis, Inc.	GoSolar@abrightideaelectrical.com
HONEY DO SERVICES	HDS@GULLINGS.COM
Honey's Air & Solar	honeysair.dale@gmail.com
Honeys Air Inc	honeysair.santos@gmail.com
Hooked On Solar	info@hookedonsolar.com
Hoover Restoration Inc	sales@hooverestoration.com
Hopkins Brothers Electric	hopkinsbrothersconstruction@yahoo.com
Horizon Energy Systems	info@gosolarnow.com
HORIZON SOLAR ELECTRIC	horizonsolarelectric@gmail.com
Horizon Solar Power	Chip@horizonsolarpower.com
Horticultural Labor Service INC.	dennis@aghouse.com
Hot Purple Energy	info@HotPurpleEnergy.com
Hot Watts Technology	paul.allen@hotwattstechnology.com
Hot Wire Electrical, Inc.	mike@hotwireelectrical.com
Hotwire Electric Corp.	hotwire62@gmail.com
Housh roofing & Construction, Inc.	bill@houshroofing.com
Howard E. Edgemon	edge@hpshome.com
Howe Custom Home Builders	HOWETOBUILD@AOL.COM
Howe Electric Construction, Inc	mark@howe-electric.com
Hubzone Corporation	charmained@msn.com
Hull Construction	jorfali@savealotsolar.com
Hunner Associates	genehunner@yahoo.com
Hunter Construction Inc.	Solar@go-hci.com
Hunter Energy Solutions	Steve@hunterenergysolutions.com
Hutchinson Construction Inc	jerad.hci@gmail.com
Hybrid Power Electric Inc.	service@hybridpowerelectric.com
Hyperion Solar	info@hyperionsolarinc.com
i.e.s. residential	jim.spencer@ies-co.com
Icenogle Construction Management Inc.	rrelente@icenoglecm.com
Ideal Plumbing, Heating, Air, and Electrical	electrical@idealsvc.com
Ideal Solar Construction Company	idealsolarco@gmail.com
IE Innovations, Inc.	patty@ie-innovations.com
IES Residential Inc	robert.smith@ies-co.com
IES Residential, Inc.	dwayne.collier@ies-co.com
IETS	special_ed_101@msn.com
III IN 1 CONSTRUCTION INC.	iiiin1@yahoo.com
Ilkyung, Inc.	seong@ilkyung.com
Image LLC and/or greenUrban LLC	greenurbansf@gmail.com
ImMODO Energy Services	jrappe@immodoenergy.com
ImMODO Energy Services Corporation	don.watson@immodosolar.com
Imperial Electric Co	mike@imperialelectric.us
Imperial Electric Service Inc.	windell@imperialelectricserviceinc.com
In Solar!	phillip@insolarco.com
Indaspec, LLC	info@indaspec.com
Independent Electrical Testing	ietroger@sbcglobal.net
Independent Energy Solutions	info@indenergysolutions.com
Indiglo Electric Solutions	sisco@indiglozone.com
Indoor Comfort Heating & Cooling Inc.	getindoorcomfort@yahoo.com
Industrial Electric	zach@indelect-ca.com
Infinite Power	infinite.power@hotmail.com
Infinity Electric	infinitysolar@yahoo.com
Infinity Electric & Solar Solutions	contact@ienss.com
Infinity Energy Inc	bsolomon@goinfinity.net
INFINITY SOLAR	info@infinitysolar.net
INFINITY SOLAR	admin@infinitysolar.net
INFINITY SOLAR, INC.	info@infinitysolar.net
Infinity Solar, LLC	palikin@infinitysolarllc.com
Inland Empire Electric Co.	mike@ieelectric.com
Inland Pacific Solar	sue@inland-pacific.com
Inland Solar Electric	info@inlandsolarelectric.com
Inland Solar Inc.	info@inlandsolar.pro
Inner City Skyline Inc.	info@innercityskylineinc.com
INNO Construction inc.	gina@innoconstruction.com
Innovative Electric Inc	bill@innovativeelectriccompany.com
Innovative Power Systems	sreed@stevensconstructioninc.net
Insoltech Solar	phil@insoltechsolar.com
Insoltech solar	phil@insoltechsolar.com
Installation Services of San Diego Inc.	contact@installsd.com
Integral Engineering Services Inc.	darren.azarian@integraleng.com
Integrated Electrical Designs	integrated.ed@roadrunner.com
Integrated Energy System Ca Inc	info@ie-systems.net
Integrated Engineering Services	Rizik@intengr.com
Integrated Engineering Services	emariner@intengr.com
Integrated Engineers & Contractors Corporation	ejordan@iec-corporation.com
Integrity General Services	igscontractors@gmail.com
Integrity Solar	Darrin@integrityhvac.com
Integrity Solar'	mona@Integrityhvac.com
InteliSolar	info@intelisolar.com
InteliSolar DBA	sales@intelisolar.com
Intelisyn, Inc.	wadaza@intelisyn.com
Intelligent Green Solutions	office@intelligentgreensolutions.com
IntelliWorx Systems Inc.	ed@intelliworx.net
Inter faith electric & fire inc	mbeale@interfaithelectric.com
Intermountain Electric	gafriffiths@imelect.com
International Custom Enterprises of CA inc.	intcust@yahoo.com
International Skylights	patsy.mcniff@acralight.com
INTI Energy	roland@intienergy.com
Ion Solar Technologies	matthew.henkin@ionsolar.net
IPC Construction	sales@ipcconstruction.net
IPI Construction	long@ipicorp.us
Iportz, Inc.	stvdrhm@yahoo.com
IPS Electric	ipselectric@roadrunner.com
Irrigation Design & Construction, Inc.	jtopham@agridc.com
ISG Electric Inc.	jsharps@isgelectric.com
Island View Electric	jeffcwelch@cox.net
Isolated Electric Inc.	Rlicea@KDRElectric.net
iSpot Solar	allan@ispotsolar.com
Ito Kensetsu, Inc.	holeshot1@gmail.com
J & J Owens Electric Inc.	ops@owenselectricinc.com
J & M Phillips Electrical & Plumbing, Inc.	admin@getpowernow.net
J A M International INC.	david_bledsoe@cox.net
J D Best Construction	jdbest1173@att.net
J E M Electric	jemelectric07@hotmail.com
J M Roofing Company Inc	sharon@aroofing.com
J R CONSTRUCTION	SolSolutions4u@gmail.com
J R CONSTRUCTION - SOL SOLUTIONS, Inc.	SolSolutions4u@gmail.com
J Y Construction Inc	jyconst@gmail.com
J&K Construction	jksolar-2010@sbcglobal.net
J&L Electric	jerry@optiononecorporation.com
J.H. Simpson Company, Inc.	michael@jhsimpson.com
J.J. Rodriguez Construction, Inc.	jgjjrh@msn.com
J.L.B. Electric	jlbelectric@verizon.net
J.M.T. Mechanical	mark@jmtmechanical.com
J.R. Zar Inc	jrzarinc@gmail.com
Jack Hanauer Construction Inc.	jack@itsaboutsolar.com
Jack of all Trades Residentail Maintenance	jackofalltrades-resmaintenance@comcast.net
Jackson & Blanc	njackson@jacksonandblanc.com
JAJ Roofing	jmoberg@citadelrs.com
JAJ Roofing & Solar dba Citadel Roofing & Solar	dfolk@citadelrs.com
Jakez Electric	hugo.jaquez@ymail.com
Jamar Electric San Diego, Inc.	phil@jamarelectric.com
James Day Construction, Inc.	ssjdconst@mchsi.com
James P. Hoffman Construction	jphconstr@comcast.net
James Scott Walker	jswzwalker@gmail.com
JAMES SHELDRAKE	jimmy@bigbugranch.com
james steven schwerm	solahart@earthlink.net
Jared Willford Electric	jared.willford@gmail.com
Jarvis electric	jarviselectric@gmail.com
Jasana, Inc.	info@agoodhandymanwithalicense.com
Jasso's Construction Company	felixjasso007@yahoo.com
JBC ELECTRIC	COCKCROFT@HUGHES.NET
JBL Solar	info@jblsolarelectric.com
JBL Solar Energy	info@jblsolarelectric.com
JBT Construction, Inc.	bob@jbtconstruction.com
JCOR Group	info@pacificelectricsolar.com
JCS Green Energy, Inc.	jake.shim@yahoo.com
JDC Energy Solutions LLC	dcobian@solaruniverse.com
JDK Electrical, Inc.	steve.jdk@mpowercom.net
JDS Power, Inc.	jon@jdspower.com
Jeff Elders Co.	jeffelders@att.net
Jefferson A/V	sjeffersonav@gmail.com
Jeffrey m. Cook Construction	cookcs@sbcglobal.net
Jeffrey Odell	johnoneil@montereybay.com
jeffrey odell construction	jgodell@comcast.net
Jenkins Construction	jenkinsconstruction3@gmail.com
Jens Jensen Design & Construction	Info@solar101.com
Jervan Electric	jervan@sbcuc.net
Jess Knolle Electric	jessknolle@yahoo.com
JESS STONE ELECTRICAL	philstone.jse@gmail.com
Jim Boe Roofing	jimboeroofing@att.net
Jim Burrow	DAVe@INLANDBUILDERSSUPPLY.COM
Jim Degen Electric	jimdegenelectric@clearwire.net
Jim Jonas Inc	millieh@jonasoil.com
jim jonas inc.	russ@jonasenergy.com
JK SOLAR ENTERPRISES, INC,	jksolar.enter@yahoo.com
JK Solar Inc	jeremy@jksolar.com
JKB Development Inc.	james@jkbhomes.com
JL Construction	jlconst408@gmail.com
JLC Contracting, Inc.	jlc_inc@msn.com
JM Builders	tiff.jer.miller@me.com
JMT Mechanical	info@jmtmechanical.com
Jocko's Electrical Service, Inc.	bruce@jockoselectrical.com
Jody Groves Construction	jgcconst@hotmail.com
Joe Fortuna Electric Co. Inc.	joefortunaelectric@yahoo.com
Joe McLean Construction	info@mcleancustomhomes.com
joe moore const.co.inc.	joe@windsunes.com
joe moore const.inc	joe@windsunes.com
Jofforts Computer Industrial Co.	allen@jofforts.com
Jofforts Computer Industrial Company	allen@jofforts.com
John Craig Construction, Inc.	jccinc@mac.com
John Fiedler	j.fiedlerroofing@prodigy.net
John J. Boscarello	adviceforfree@aol.com
John Miecke Construction	john@mieckeconstruction.com
John Owens Services, Inc.	johnowensservices@gmail.com
John Padilla Plumbing	Johnnie@jpplumbers.com
John Perkins	johnjohnperkins@yahoo.com
Jonathan Alwine	jonalwine@me.com
Jonathan Electric	busybunch77@msn.com
Jones Electric	mjoneselectric@yahoo.com
Jones' Solar Electric	jse@dishmail.net
Jose Bahena	scott@kndenergysolutions.com
Joseph Crown Construction and Development Inc.	jcrown@crownliving.com
Joynus Construction Co	joynuscon@yahoo.com
JP and Sun, Inc.	info@solarworksca.com
JP Building Contractor	cichlidfish@hotmail.com
JP Electric	jpelectric1@msn.com
JP ELECTRIC	jpelectricdesigns@gmail.com
JP Electric & Solar	jpelectric1@gmail.com
JP electrical	jp.electric@gmail.com
JP Service Inc.	info@ecoluminaireusa.com
JQS Construction Services	scomckin@aol.com
JR Nelson Roofing Inc.	jrnelsonroofing@yahoo.com
JS Solar & Electric	josh@sanchezsolar.com
JT Solar Inc	jeff@jtsolarinc.com
JTN Construction	onirrep@gmail.com
Juan Nunez Construction	rparker002@ca.rr.com
JUDSON ENTERPRISES	jfrench@k-designers.com
June Company	sales@juneenergy.com
K & L Inspection Service Inc.	kandlinspectiontravis@sbcglobal.net
K&B Electric	John@kbelect.com
K. Tyler, Inc	kentyler@cds1.net
k.c.electric company	kcelectric@cox.net
K2 Solar, Inc.	info@k2solar.com
Katalyst Construction	dan@katalystconstruction.com
Katri and Dart Electric	jkatri@sbcglobal.net
KB Home Inc	jyoung@kbhome.com
KBSOLAR	info@kbsolar.com
KDB Custom Lighting & Electric	kdbenterprises@hotmail.com
Kear General Construction	kearconst@gmail.com
KearneyHomes	kearneyhomes@gmail.com
Kebeco Construction Services, Inc	kebecoconstruction@yahoo.com
Keith Smith and Son Inc.	art@servicelectric.net
Kelly Brother's Painting, Inc.	mark@simple-power.com
Kembar, Inc	info@dkam.net
Kenard Construction Company, Inc.	arden@kenard.net
Kennon Electric	kennonelectric@sbcglobal.net
KENT SALVESON	Kent1199@Gmail.com
Kern Mechanical KMI	kernmechanical@gmail.com
Kern Valley Construction, Inc.	rachel@kvc-inc.com
KERNTEC Industries, Inc.	dontwant@emailaddress.com
Kettle Construction Inc	dkettle@me.com
Kevin Anderson Construction	Kevin@kandersongc.com
Kevin Scheibel Company	ks93561@yahoo.com
Key Energy Solutions	chad@mykes.biz
Keynes Business Services, Inc.	admin@lightpowersolar.com
Khan Construction Co	khan.solar@yahoo.com
Kianga Solar Builders Inc.	info@kiangasolar.com
Kilowatt Heat, Air Electric & Solar	Dean@KilowattAC.com
Kings Community Action Organization	sleal@kcao.org
KINSMAN SOLAR POWER SYSTEMS, CORP.	KSPS.CORP@ymail.com
KIRK STAR ELECTRICAL	LEO_KIRK1@MSN.COM
Kitchen & Bath Factory And Construction	solar@kandbfactory.com
Kitchen & Bath Factory and Construction	solar@kandbfactory.com
Kitchen Art Inc	KitchenArt@msn.com
Kliewer Construction Inc	info@kliewercustoms.com
KLS Facility Maintenance Corp.	Kevin@fm1.com
KM electric	kmelectricinfo@gmail.com
KM ELECTRICAL SERVICES	kevin@kmelectricservice.com
Knex Construction, Inc.	weis@earthlink.net
Knight Roofing Services, Inc.	david@knightroofing.com
KnightWorks Electrical	sknight@goknightworks.com
Knowles Solar Inc.	ty@knowlessolar.com
Koch & Koch Inc	ric.eli@kochinc.com
KoiSolar	coy@southfacesolarpower.com
Komodo Enterprises, Inc.	amy@monkeyis.com
Koston Construction Co.	jerry.koston@gmail.com
KRC Enterprises Inc.	krsolar@gmail.com
Kruetzfeldt Construction Company, Inc.	kkruetzfeldt@solaruniverse.com
Kruzick Plumbing, Inc	dkplumb@sbcglobal.net
Kurios Energy	info@kuriosenergy.com
Kurios, Inc	info@kuriosenergy.com
Kuykendall Construction & Solar	kuykendallsolar@gmail.com
Kuykendall Electric	kuykendallelectric@gmail.com
KV Electric	Kvelectric@yahoo.com
KV Solar Supply	kvsolarsupply@yahoo.com
kwak joon	enpos1975@hotmail.com
Kyle Hanson Construction	kylemhanson@yahoo.com
Kyle reed	Valley.electric@yahoo.com
L E Construction	Luis@LEConstruction.net
LA Builders & Designs Inc	labuilders@yahoo.com
LA Sieber CSI Company	office@thecsico.com
LA Solar Group	info@lasolargroup.com
LA Solar Systems, Inc	info@lasolarenergy.com
LA's Premiere Construction, Inc.	g35tigercoach@yahoo.com
Laguna Integrated Energy Systems Inc.	mbeverly@ie-systems.net
Laibach Solar, LLC	dejan@laibachsolar.com
lakeshore electric & engineering co inc.	lakeshor_electric@sbcglobal.net
Lamb Energy, Inc	bev@lambenergy.com
Lamb Energy, Inc.	brad@lambenergy.com
Lance Bond Installations Inc	lanbond007@aol.com
Landon Electric	sahron_landon@comcast.com
LaPerle Construction	vlpconst@yahoo.com
Largo Construction	phase1_inc@yahoo.com
Larry D. Hazelton General Contractor	lhazelton@dc.rr.com
Larry Freeman Construction	freepersonsb@cox.net
Larry Knadler Electric	lpknad@gmail.com
Larry Phillips Construction	lphillipselectrical@gmail.com
Laser Electric Inc.	denise.hartnett@laserelectric.com
Latura Builders,Inc	swiftcon@pacbell.net
Lawrence Electrical Contracting	anth.lawrence@sbcglobal.net
Layman Electric Inc	Eric@Laymanelectric.com
LColumna General Contractor	lcolumna@sbcglobal.net
Leavenworth Electric Inc.	sparky@redshift.com
LECHER HEATING AND AIR CONDITIONING INC	airgame2000@yahoo.com
Lee Limperis Construction	leedl@sbcglobal.net
Lee Wilson Electric Co.	bud@leewilsonelectric.com
Lee Wilson Electric Co., Inc.	bud@leewilsonelectric.com
Lee's Accu-Tech Service, Inc	bryanlee@leesair.com
Leeway Construction	bradyr@renewableusa.com
Legend Homes Inc.	legendhomes.chad@gmail.com
Legend Pools and Builders, Inc	legendbuilders1@verizon.net
Legends Custom Remodeling	legendscustomremodel@gmail.com
Lenders Solar	norman@lenderssolar.com
Lenzi Incorporated	info@lenzicon.com
Leonard Roofing Inc	bruce@leonardroofing.com
Leone Electric	leone.electric@yahoo.com
LESSLEY CONSTRUCTION	greensolarsolutions@yahoo.com
LEUCADIA ELECTRIC, INC	cindy@leucadiaelectric.com
Lexcomm	Mick@lex-comm.com
Liberty Energy, Inc.	Steveheriford@sbcglobal.net
Liberty Solar	info@LibertySolarSystems.com
Lifestyle Solar Inc	larry@lifestylesolarinc.com
Lifestyle Solar, Inc	larry.hoang@yahoo.com
Lifestyles Solar Power Systems	jperierasolar@yahoo.com
Lifetime Solar	help@lifetimesolar.co
Lighthouse Construction Consultants	ezlighthouse@yahoo.com
Lighthousesolar-Central valley	mmerigiangarcia@lighthousesolar.com
LIGHTMAN ELECTRIC	mario@lightmanelectric.net
Lightning Solar	lightningsolar@gmail.com
Lightray Electric	ross@lightrayelectric.com
Lin Spier Construction	lin.spier@gmail.com
Lind Electric	lind64@comcast.net
Lindholm Engineering Consultants	steve@lindholm-engineers.com
Lindy Roofing Co.	lindyroofing@earthlink.net
Linn Construction & Design	linnconstruction@yahoo.com
Linnert Roofing Inc.	linnertroofing@aol.com
Liquid Lion Electric	bill.goad@liquidlionelectric.com
Lite Solar Corp	lestatarkady@yahoo.com
Live Wire Electric	ahudsonelectric@yahoo.com
Livebythepark Inc	d@lbtp.net
LIVING GREEN INC.	donn@livinggreenincsc.com
Lloyd's Electric	info@lloydselectric.biz
LLP Energy Inc.	kristiana@llpenergy.com
LLP Energy, Inc.	patrick@llpenergy.com
Local Builders	earth4power@yahoo.com
locken enterprises	marland@lockenenterprises.com
Lockwood Electric Co.	lockwood@lockwoodelectric.com
Lockwood Enterprises	joeldlockwood@yahoo.com
Lodi Services Heat & Cooling	lodiservices@sbcglobal.net
LOMA PRIETA BUILDERS	95033@comcast.net
Lon's Electrical Service Inc.	craig@lonselectric.com
Long's Construction	buildcustom4u@aol.com
Longs Construction and Energy Solutions	longscoenergy@gmail.com
Loomis General Contracting Company	shad@energyprosllc.com
Lorax	andy@loraxsolar.com
Lost Coast Electric	a.lostcoastelectric@gmail.com
Lost Coast Electrical	lostcoastelectric@gmail.com
Love Electric & Solar	cmlove@nsis.org
Low Voltage Solutions	m12macissac@gmail.com
Lowell Martin Electric, Inc	lmei@sbcglobal.net
LP DANIEL ENGINEERS AND CONTRACTORS	ldaniel007@aol.com
LTS SOLAR ENERGY	lslominski@aol.com
Luc Enterprises Inc.	Justin@californiacoolsolutions.com
Lucerne-Pacific, Inc	peter@lucernepacificinc.com
Luhr Design and Construction Inc	luhr@charter.net
Lundy Construction and Maintenance Co.	customercare@lundycon.com
Lusin Corporation	sales@lusin.com
Lux Energy	fab@lux-energy.com
Lyle Design	lyledesign@yahoo.com
Lyons & Company USA Inc.	eamon@lyonsco.net
M & K Electrical & Plumbing Heating & Air Conditioning	mike@mkelectricalplumbing.com
M D Electric	mdelectric@mcn.org
M Kahn Solar Inc	m.kahn@kahnsolar.com
M P ELECTRICAL	mike.redja@epsolar.com
M V Style Electric Inc	mvelectric32@aol.com
M&S Construction Co.	msconco@gmail.com
M. B. Herzog Electric	kevin@herzogelectric.com
M. Brey Electric, Inc	matt@mbreyelectric.com
M. L. Meintel	mlmeintel@cox.net
M. Sanderson Construction & Design Inc	monica@sosenergyinc.com
M.I. Electric	mielectric1@cox.net
M.I.T.Electrical Installations	m.i.telectricalinstallations@gmail.com
M.J. Wilson Contractors Inc.	Mikewilson569@yahoo.com
Mac Dwight Electric	macdwightelectric@yahoo.com
MAC Electric, Inc.	ari@mei.com
MacQuarrie Electrical services	craig@macquarrieelectric.com
MADDOG ELECTRIC	martinulbrich@myway.com
Maddox Home Improvements	maddoxfamofs@sbcglobal.net
Maedl Construction	info@maedl.com
Maggetti Construction	operations@freedomsolar.net
Maggetti Construction, Inc.	sales@freedomsolar.net
Magic Sun Power Inc	emin@magicsolar.net
Magic Sun Solar Inc.	theguru@magicsunsolar.com
Magic Sun Solar, Inc.	lcarr@magicsunsolar.com
Magnolia Heating and Cooling	info@maghvac.com
Magyar Electric, Inc.	dan@magyarelectric.com
Maine Electric	dean@maineelectricav.com
Maine Electric Inc.	maine.electric@sbcglobal.net
Majestic Roofing, Inc.	majesticroofing@hotmail.com
Malcon civils Inc.	mbdaiwi@malconcivils.com
Malone Controls Corp.	bobm@malonecontrols.com
Mammoth Sierra Electric	martin@mammothsierraelectric.com
Manada Roofing Inc.	beatriz@manadaroofing.com
Mangan Renewables LLC	hdboesch@manganinc.com
Mangan, Inc.	rmotonaga@manganinc.com
Mann Electric,Inc.	mannelectric@ymail.com
MAP Productions	mapprod@earthlink.net
MARB Construction Management, Inc	marbeng@gmail.com
Marco Roofing	marcoroof@sbcglobal.net
Mariner Mechanical Inc.	info@adroitsolar.com
Mariposa Termite Control	casners@sti.net
Mark B Kirk, Inc	mark@markkirk.com
Mark B Kirk, Inc.	mark@markkirk.com
Mark Carsey Construction	mcarsey@cox.net
Mark J. Heinz	solarnow.heinz@yahoo.com
Mark Miller Contracting Inc.	Mark.mmcontracting@gmail.com
Mark Miller Electrcic	mark.mmcontracting@gmail.com
mark mino electrical construction co.	markminoelectric@gmail.com
Mark Roberts	mdr2062@gmail.com
Mark S. Drop Sr. Corporation	green_analysis@yahoo.com
Mark Snyder Electric	marksnyderelectric@sbcglobal.net
MARKREADY ELECTRIC, INC.	mark@markreadyelectric.com
Markus Burkhart Construction Inc	markusburkhartconst@gmail.com
Martifer Solar USA	info@martifersolarusa.com
Martin Electric & Solar, Inc.	natalie@martinelectricandsolar.com
Martin Herzfeld	findsolar@herzfeld.org
Martin Roofing Co. Inc.	fred@martinroofing.net
Martin W Hill Electric	scott@daleyhomes.com
Martin's Electrical and Lighting Company	martin@martins-electrical.com
Martinez Electric inc.	speedywiring@aol.com
Masamitsu Kamimoto	mikekamimoto@yahoo.com
Masellis Electric & Solar, Inc.	masellissolar@yahoo.com
masterlyne Corporation	info@masterlyne.com
Mathew L McCarty	mmconst@me.com
Matson - Services	matsonut@msn.com
Matt Thompson Solar	mattthompsonsolar@gmail.com
Maverick Woodworking Custom Home Builders	johnsteed@earthlink.net
MB HERZOG ELECTRIC	alton@herzogelectric.com
MBG NEW YORK ELECTRIC COMPANY	mbgnewyorkelectric@gmail.com
MBKT Corp	askmike@mcelectric.co
Mc Cormack Roofing & Window Co.	jimmc@mccormackroofing.com
Mc Lean Roofing, Inc.	mcleanroofing@sbcglobal.net
MC Solar	MCsolar1984@yahoo.com
MC2 Engineering & Construction Services, Inc.	info@solarmonkey.net
McCaa Electrical Construction	Mccaaelectric@gmail.com
McCalmont Corporation	tom@mccalmont.net
McCarley Electric, Inc.	jswartz@mccarleyelectric.com
McCoy Electric Corporation	info@mccoyelectric.net
McCullough Design Development Inc	bryonny@mddhomes.com
McCullough Engineering	McCulloughEngineering@gmail.com
McDaniel Inc	Tim@McDanielInc.net
McDonell Electric Inc.	eric@mcdonellelectric.com
McGuire Construction Services, Inc.	mcguire108@gmail.com
McKeever Energy & Electric, Inc	nate@mckeeverenergy.com
McLean Energy Inc	Mike@McLeanEnergyInc.com
McMann Electric	ialexmcmann@gmail.com
McWire Electric	info@mcwireelectric.net
MD Construction and Consulting Inc	miken@md-construction.com
MD Electric & Solar, Inc.	mdelectricsolar@gmail.com
MD Energy, LLC	danny@mdenergyllc.net
Mediterranean Heating & Air Conditioning Inc.	lgoodman@mhac.com
MEE-Solutions Inc	marcus@mee-solutions.com
Mega Power Electric Inc.	info@megasunpower.com
Mehl/Bishop Electric Co Inc	mehlbishopelec@wildblue.net
Mehr US Corporation dba Mehr Solar	cmiller@mehrsolar.com
Mel Bradley Electric	mgb33@msn.com
Mel Dion Cardinal Inc	cardinal@cruzio.com
Mello Electrical Service	dmello41@hotmail.com
Memeged Tevout Shemesh	info@titansolarco.com
Mendocino Solar Service	msolar@mcn.org
Meterman, Inc.	shirley@metermaninc.com
METRO BUILDERS & REMODELING	metro.remodeling@yahoo.com
metro solar design & installation inc.	m_davis1350@yahoo.com
Metrocell Construction Inc	jamesculwell@metrocell.org
MHD Studio Design and Construction	mike.bernard2012@yahoo.com
MHER Construction	mherconstruction@gmail.com
michael a. novak -GC - the novak co.	manovak123@gmail.com
michael croisette electric inc	mike@mcelectric.biz
michael delvalle construction	michaeldelvalle@hotmail.com
michael electric	simon@michaelelectric.net
Michael J Dehority	stopbotheringme@gmail.com
MICHAEL KUNDYSEK ELECTRIC	mkundysek@gmail.com
Michael Lenton Construction	mlcpasadena@yahoo.com
Michael Lukche Li	michaellukeli@msn.com
Michael McEachern	Michael@SouthlandSolarNow.com
Michael Ryan Electric	mikearyan711@gmail.com
Michael Stonecipher	mikestonecipher@bak.rr.com
Mid-State Solar	midstatesolar@softcom.net
Midco Electric	midcoelectric@aol.com
Midtown Electric,Inc	midtownelectric@roadrunner.com
Midwest Roofing and Solar	andrew.midwestroofingandsolar@gmail.com
Miecke Construction	john@mieckeconstruction.com
MIKE CONKLIN	MIKE@CBROS.NET
mike smith construction	myksantq@mchsi.com
Mike's Electric	mikepbenson@earthlink.net
Milcon Services, Inc.	bill@milconservices.com
Milholland Electric Inc.	brian@milhollandelectric.com
Millennium Development Corp, INC	chris@solnv.com
Miller Solar Installation & Service	millersolar@att.net
Mimeos Corporation	matt@mimeos.net
Mimms Electric Inc.	mimmselect@aol.com
Minich & Sons Construction	cody@minichandsons.com
MIRACLE SOLAR INC.	mike@gomiraclesolar.com
Mission Solar Electric	jpinon@cox.net
Mission Valley Roofing Inc.	sales@missionvalleyroofing.com
Mitchell Electric Inc	MitchTellez@comcast.net
MJB Homes, Inc.	MJB@MJBconstruction.com
MJR Electric Inc.	Michael@mjrelectric.com
MJS Electric Inc	jgreer@mjselectric.com
MKS Electric and Solar Inc.	mkselect@gmail.com
MODERN BUILDERS CONSTRUCTION	JIMENEZMC73@GMAIL.COM
Modern Coatings	briang@moderncoatings.net
Modern Electric	Mdernelectric11@hotmail.com
Modern Solar Electric	Lwhiteside@modernsolar.com
modern tech electric	mte2020@sbcglobal.net
Mohler Electric	earl.mohler@gmail.com
MohrPower Solar, Inc.	cher@mohrpower.com
MONARCA GENERAL CONSTRUCTION	jesus@manadaroofing.com
Moonlight Electric Services, Inc.	moonlight818@gmail.com
Moore Solar & Green Construction	vzerman@mooresolar.com
Morey Construction	morey.construction@moreyconst.com
Morningstar Electric	morningstar@snowcrest.net
Morrow-Meadows Corporation	gdesoto@morrow-meadows.com
Mother Nature Solar	mcd151@yahoo.com
Mount Shasta Energy Services	toddcory@yahoo.com
Mountain Aire Heating and Airconditioning Inc	steve@mtn-aire.com
Movses Meymarian Construction	mmeymar889@aol.com
MP Electric and Solar	matt@mpelectricandsolar.com
MPE Consulting	info@mpeconsulting.com
Mr. Roofing and Solar, Inc.	crodriguez@solaruniverse.com
Mr. Sunshine Solar LLC	mr.sunshine.solar1@gmail.com
MS Construction	info@msconstruction-la.com
MS Navarro Engineering	kedypn@msnavarro.com
MSL Solar	info@mslsolar.com
MT Planning Design	michaelthanh@gmail.com
Mulick Construction & Design, Inc.	ron@mulick.com
Multi Power	dan@multipowerss.com
Murphy Electric Company	malik@diamondenergysol.com
Mustang Electric inc	wiremanguy2003@yahoo.com
Muzio Energy Inc	james@MuzioEnergy.com
MW Construction Inc.	scott@mwconstruction.com
My Electrician Online	talk2dan@cox.net
N&A Electric	naelectric@uscellular.blackberry.com
Naildown Construction	angela@ndcenergy.com
Nakhshab Development & Design Inc.	soheil@nddinc.net
Napa Electric	pgrafton@napaelectric.com
Nationwide Environmental and Construction Services Inc	Frankd@environation.us
Nationwide Sun	LEIFH@ENVIRONATION.US
NationWize Solar	marvin@natwize.com
Native Electrical Construction Inc	willhobbs@nativeelect.com
Natrium LLC	ben@natriumsolar.com
Natural Energy USA	kelley@naturalenergyusa.com
NaturEnergy Inc.	srh@naturenergy.net
Navajo Solar	waltwands@hughes.net
Navco Group, LLC	info@renewableusa.com
Neal Electric Corp.	fhaslinger@nealelectric.com
Neale Ferguson	fergy_5@att.net
NEI Contracting and Engineering, Inc.	Nicola@NEIContracting.com
NEI Contracting and Engineering,Inc	ericbarajas@neicontracting.com
Neighborhood Power Corporation	info@simplesunpower.com
Neighborhood Power Corporation	cbennett@municipalsolarcorporation.com
Neil Christman General Contractor	12@34.com
Neil Splonskowski Lighting Design, Inc.	neil@lightingdesign.la
NET ELECTRIC, INC	info@netelectric.biz
NetZero Energy LLC	info@zeroenergybill.com
Neumann Construction	neumannconstruction@comcast.net
New Day Solar	mary@newdaysolar.com
New Energy Construction, Inc.	jay@newenergyconstruction.com
New Energy Solutions	contractor@arecinc.com
New Gen Energy Corporation	jennifer@newgensolar.net
New Horizon Solar Electric, Inc.	mike@newhorizonsolar.net
New Solar Electric Inc	info@newsolarinc.com
New Solar Inc	info@newsolarinc.com
Newport Power	jreeve@newportpower.com
NexGen Construction Services, Inc	Denise@NexGenConstruction.com
Nexgen Energy Systems, Inc	mike.mcgoey@nexgenes.com
NEXT GENERATIiON ALTERNATIVE ENERGY, INC	EABITBOL@NEXGENERATION-AE.COM
NEXT GENERATION ALTERNATIVE ENERGY, INC	EABITBOL@NEXGENERATION-AE.COM
Next Generation Solar Inc	info@csbcinc.com
NextEnergy	emma@nextenergysolar.com
Nexus Energy Systems	mike@nexusenergysystems.com
NGH Construction and Design	NGHConstruction@yahoo.com
Nibbi Brothers Associates	rickf@nibbi.com
Nippon Energy	info@nipponenergy.com
NJ Electric Inc	nj.electric.inc@gmail.com
Njoord Incorporated	jreeve@newportpower.com
Noble Electric	jimnobleman@gmail.com
Noble Roofing	Nobleroofingco@sbcglobal.net
Nopec, Inc. d/b/a Run on Sun	questions@runonsun.com
Nor Cal Home Improvements	paigemalin@norcalhomepro.com
Nor Cal Solar	norcalsolarinc@att.net
NorCal Home Improvements	norcalhomepro@aol.com
Norcal PV LLC.	ted@norcalpv.com
Norris Electric Inc	norrisel@pacbell.net
North American Diversified Inc.	Garry@b-b-electric.com
North American Green Energy, Inc.	thoyt@southwesternsolarsystems.com
North Coast Contracting, Inc.	seandurenberger@sbcglobal.net
North Coast Refrigeration and Electric, Inc.	ncre@mcn.org
North Coast Renovators, inc.	ncr@willitsonline.com
North County Solar	northcountysolar@gmail.com
North West Builders	rodrohrs@yahoo.com
Northern Pacific Power Systems	gbeverly@northernpacificpower.com
Northern Pacific Roofing, Inc.	barry@northernpacificroofing.com
Northwest Exteriors, Inc.	patioman@northwestexteriors.com
Northwestern Electric	northwesternelectric@gmail.com
Norwood Electrical Construction, Inc.	mikehnorwood@gmail.com
Nostalgic's Inc.	Roy@nostalgicsgreen.com
Nova West Solar Inc.	andrew@novawestsolar.com
Novak Construction	craig.novak@sbcglobal.net
Novel Remodeling	novelremodeling@gmail.com
NRB/BahamaSolar.Com	noel@bahamasolar.com
NRG Clean Power	info@nrgcleanpower.com
NRG Electric	peter@nrgelectic.net
NRG Heating and Air Conditioning	salesconsulting@nrgair.com
NRG Systems	nrgsystems1@gmail.com
Nunes Electric Corporation	nunesamps@aol.com
NuVision	chris@nuvisiones.com
NWEC Nevada Inc	joe@newwaveelectric.com
O'Brien Electric Co., Inc.	todd.obelectric@yahoo.com
O'Sullivan Construction	johneosullivan@hotmail.com
O&R Building Services, Inc.	shaun@oandrbuilding.com
Oak Electrical	mail@oakleafsolar.com
Oak Leaf Solar & Electrical	delectric09@yahoo.com
Oak Tree Construction	dprovine@sbcglobal.net
OakRidge Design & Development, Inc	oakridgedd@gmail.com
Oasis Design & Construction	e.peterson@cedg-design.com
O‚ÄôNeil Electrical Contracting	trmz450@yahoo.com
OC Home Improvement	gary@ochomeimprov.com
OC Property Services, LLC	OCPropertyServices@hotmail.com
OC Sunny	info@ocsunny.com
OCR Solar & Roofing, Inc.	cledo@petersendean.com
OCS Energy, Inc.	mcoc@ocsenergy.com
Offline Solar Electric	brookehanner@sti.net
OHM Solar	wattsup@ohmsolar.net
Ohmic Electric	ohmic@comcast.net
Ojai Solar, Inc.	info@gomegasolar.com
Okeson construction inc	sokeson@cox.net
OMNI Valley Construction Corp	larry@ovcelectrical.com
One Energy of California	chrystal.ellerbe@myoneenergy.com
One Sky Homes	allen@oneskyhomes.com
One Sun Energy, LLC	california.solar@gmail.com
One Sun Inc.	bibi@onesuninc.com
One Sun, Inc.	peter@onesuninc.com
Online Clean Energy, Inc.	billy@onlinecleanenergy.com
OP CONSTRUCTION	ottopalmer@yahoo.com
Option One Corporation	info@optiononesolar.com
Oran's Electric	Info@Oranselectric.com
Orange Coast Contractors	occ0115@yahoo.com
Orange County Electric, Inc.	ocelectric@sbcglobal.net
Orchard City Solar	tzeman@orchardcitysolar.com
Orion Communication Inc	accounting@tcp.ms
Ortega R's Construction	o_agustin@hotmail.com
Oscar Martinez Development & Construction Inc.	greenscene@mac.com
OTM Designs & Remodeling Inc.	service@otm1designs.com
Otto H. Rosentreter Company	ken@ohrenergy.com
Outdoors and Beyond, Inc	info@sun4solar.com
Oxypower INC	paul@oxypower.com
Ozzimo Electric Inc	ozzimoelectric.dennis@verizon.net
P C H Electric	michelle_cassidy@ymail.com
P-H-D Enterprises	mfigearo@p-h-dsolar.com
P.F. Kennedy Construction	emailpatrickkennedy@gmail.com
P.T. Electric	patptelectric@aol.com
PACE	sspajic@pacela.org
Pacific Beach Tower Inc	les@pbtower.com
Pacific Blue Electric, Inc.	gregorycaul@pacificblueelectric.com
Pacific Blue Solar, Inc.	pacificbluesolar@mac.com
Pacific Bluegrass Solar	tmhet@pbgsolar.com
Pacific Clean Energy	fraydoonr@gmail.com
Pacific Coast Electric Company	pce4u.com@gmail.com
Pacific Coast Home Improvement and Construction Inc.	pacificcoasthi@live.com
pacific coast wind and solar	pacificcoastwindandsolar@gmail.com
Pacific Design & Construction	alanloghman@gmail.com
Pacific Electric Lighting and Sound Inc	c-blake@wbwaltonelectric.com
Pacific Electric Worker-Owned Co.	info@pacificelectric.coop
Pacific Electrical Contractors, Inc.	info@pacificelectrical.com
Pacific Energy Co *(SLOPEC)	john@alteryourenergy.com
Pacific Outlook	chrisg@pacoutlook.com
Pacific Power Management, LLC	janh@pacpower.biz
Pacific Pro Solar Group, Inc.	billnuttall@pacificprosolar.com
Pacific Rim Construction	aram@aramsolar.com
Pacific Solar Energy	info@pacsolarenergy.com
Pacific SonLight Electrical Services, Inc.	harriet@PacificSonlightElectric.com
Pacific Stonegate Inc. DBA Solar Vast	service@solarvast.com
Pacific Sun Technologies, Inc.	steve@pacificsuntech.com
Pacific Utility Inc.	krsolar@gmail.com
Pacific View Construction	david@pacificviewsolar.com
Pacific Wide Electric Inc.	mbernatz@gmail.com
Padcor	padenconstruction@sbcglobal.net
Palo Cedro Electric	Pce1@citlink.net
Palomar Solar	info@palomarsolar.com
Palomar Solar Ltd	info@palomarsolar.com
Panelized Structures, Inc.	ron@panelized.com
Par Electric	parelectric1@aol.com
Par Electric Solar Sales	katherine@elysianci.com
Paradise Electrical Services Inc	jeff.paradisecompany@gmail.com
Paradise Solar, Inc.	jeff@paradisecompany.com
Param Electric Inc	paramelectric@comcast.net
Paramount Energy Solutions	jgrube@paramountsolar.com
Paramount Energy Solutions, LLC	tlindstrom@paramountsolar.com
Parks Electric	Bill@parkselectricsocal.com
Parsa Tech Inc.	parsafire@aol.com
Participant Energy CA Inc.	ngs@participantenergy.com
PassivWorks, Inc.	rick@passivworks.com
Pasternak Construction	pasternakconst@citlink.net
Path Electrical Technologies	Steve@pathelectrical.com
Pathways Energy, Inc.	barry@pathwaysenergy.com
Patriot Roofing Inc.	dave@patriotroofing.com
Patriotic Power Solutions LLC	pauls@patrioticpower.com
Patriotic Power Solutions, LLC	Phillip@PatrioticPower.com
Patterson & Patterson	dennis@solarpowerissmart.com
Paul Davis Restoration of San Diego, Inc.	psvedlund@pdrasd.com
Paul Gysels Construction	pagcopaul@hotmail.com
Pav-Solar	dadams@pavelectric.com
Pavletich Electric	spavletich@pavelectric.com
PC Electric, Inc.	billnuttall@pcelectricinc.com
PCL Industrial Services Inc.	WBishop@PCL.COM
PCM Prudential Construction and Mgt.	fgamwell@pcmla.com
PD Solar, Inc.	solar@petersendean.com
PDE Total Energy Solutions	skeltner@pdeinc.com
Peace of Mind Electric	peaceofmindjosh@aol.com
PEACHEZ INC DBA	cwalker@airmanagementsystems.net
Peak Power Solutions	sherri.lockwood@peakpowerus.com
Pellyo Services Inc	john@acepelizon.com
Peninsula Consolidated Services	gary@peninsulasolar.com
Peninsula Solar	gary@peninsulasolar.com
Penna Electric, Inc.	pennaelectriccompany@gmail.com
Pennies a/c-heating, solar & construction	pennies4air@yahoo.com
Pennies a/c-heating,solar and wind	pennies4air@yahoo.com
Pentiger Construction	pentigerc@yahoo.com
Pereira Building Industries	jean_paul_pereira@hotmail.com
performance contracting inc	zac.paxton@pcg.com
Performance Heating and Air	curtisb@innercite.com
Perkett Construction	ron@perkettsolar.com
PermaBuilt Remodeling & Solar	info@permabuiltcorp.com
Permacity Construction Corp	solar@permacity.com
PERMANENT ENTERPRISES CORPORATION	may55252962@yahoo.com
perron construction	perron48@calwisp.net
Perry Roofing Inc.	info@PerryRoofing.net
Personalized Pool Care	Personalizedpoolcare@gmail.com
Pete & Sun	desimone@mcn.org
Peter's Solar Installations	peter@apparent.com
PETERSEN-DEAN, INC	solar@petersendean.com
PH Electric	paulphelectric@att.net
PHASE 1 ELECTRIC & TELECOM	P1ELECTRIC@SBCGLOBAL.NET
Phase 9 Science and Technology	CSIaccount@phase9.com
PHAT Energy	info@PHATenergy.com
PHAT Energy Corporation	ph@phatenergy.com
Phazer Energy	mturco@phazerelectric.com
Phazer Energy, Inc	gturco@phazerelectric.com
Phil Tyrwhitt's Pure Energy	ptenergy@aim.com
Phoenix Energy	Lamarp@phxenergy.info
Phoenix Energy & Construction	lamar@phxenergy.info
Phoenix Energy Solutions Inc	micah@gophoenixenergy.com
Phoenix Solar Incorporated	p.beucke@phoenixsolar.us
Phollies Inc	phollies@comcast.net
Photon Brothers Inc.	itzia@photonbrothers.com
Photon Solar Power Inc.	pekkajlaine@att.net
Pickett Solar	jeff@donpickett.com
Pierro Solar	repierroconstruction@cox.net
Pinski Construction	dpinski@comcast.net
pioneer construction works	pcworkskj@gmail.com
Plan It Solar	gil@planitsolar.com
Plan It Solar - Sierra Solar	info@planitsolar.com
Planet Earth Solar	matt.ashwell@planetearthsolar-co.com
Planet Solar Inc.	info@planetsolarinc.com
Planet Solar Incorporated	info@PlanetSolarInc.com
Planet Solar Solutions	Solutions@PlanetPV.com
PLATEAU BUILDING GROUP, INC.	homes@plateaubuildinggroup.com
Plenarius Comfort Solutions	iNFO@PLENARIUScOMFORT.COM
Plug in the Sun	info@pluginthesun.org
PM&M Electric Inc	wsbaz@cox.net
PMK Professional Inc.	mahyar@pmkpro.com
PO Construction Inc	james25031950@yahoo.com
POCO Solar Energy, Inc.	info@pocosolar.com
Poillon Electric	peter@poillonelectric.com
Points west Commercial inc	eaglechuck@aol.com
Polar Solar Inc.	admin@uspolarsolar.com
Positive Energy Solutions, Inc.	info@smart2gosolar.com
POWEN CHEN	paul5525@hotmail.com
Power Concepts Facility Services, Inc.	shavey@powerconfs.com
Power Concepts Facility Services, Inc.	info@powerconfs.com
Power Electric	powerelectric2@gmail.com
Power Electric & Construction	powerelectric@ca.rr.com
Power Electric.	info@powerelectricone.com
Power Electrical, Inc.	powerelectricalinc@yahoo.com
POWER IT FREE SOLAR SOLUTIONS	INFO@POWERITFREE.COM
Power Link	PLinfo@powerlinkservices.com
power systems electric	powersystemselectric@gmail.com
Power Up Energy Solutions	powerupes@sbcglobal.net
Power-Spar Concentraded Solar, Inc.	info@powerspar.com
Poweraid, Inc.	nick@poweraidus.com
Powergridinc	aaron@powergridincsolar.com
PowerHouse Solar Inc	nicole@powerhousesolar.org
PowerHouse Solar, Inc.	sue@powerhousesolar.com
Powerhouse Systems, Inc.	jake@solarpoweryourworld.com
Powertek Electric	powertek@cox.net
PowerTown Solar Electric Inc.	info@powertownsolar.com
Prabhas Kejriwal	prabhas@alumni.stanford.edu
Precis Solar	info@precissolar.com
Precise Air Systems Inc	anita@preciseair.com
Precise Framing	preciseframing1@att.net
Precision Remodeling	wcprecisionr@aol.com
Precision Solar	micah@precisionsolar.net
Preferred Construction Company	jimmy@greenlionsolar.com
Preferred Electric	brad@preferredelectriconline.com
Premier Energy Electrical Services, Inc.	premierenergy@sbcglobal.net
Premier Power Renewable Energy Inc.	info@premierpower.com
Premier Solar, Inc.	Erin@bnigc.com
Prevailing Wind Power	bhayes@prevailingwindpower.com
Prime Electric	Gary@primelectric.com
Prime Solar Co	bill@prime-solar.com
Prism Electric	kyle@prismelectricsocal.com
PRM Inc.	phollies@comcast.net
Pro Energy Solution	hernandezalfonso661@gmail.com
pro solar systems	prosolar1@gmail.com
Pro Star Services inc.	brian@prostarservicesinc.com
PRO-AIR INC	proair@surewest.net
PRO-LINE ELECTRIC CO.	jeff@jhproline.com
Process Communication Developers, Inc.	rebates@poterocorp.com
Progressive Energy Solutions, Inc	David@pesisolar.com
Progressive Power Group	cjs@propowergroup.com
Project GO, Incorporated	lynda@projectgoinc.org
Promise Energy Inc	charlie@promisenergy.com
ProQuality Contrcting, Inc.	mtrozera@cox.net
PROTEL COMMUNICATIONS INC	TW@GOPROTEL.COM
ProVolt Energy	sales@provoltenergy.com
ProVoltz Inc	info@provoltz.com
PSG Solar & Alternative Energy, Inc.	russell@psgsolar.com
Pterodactyl Construction Co. Inc.	mjptero@comcast.net
Pullman Construction Inc	pullmanhc@sbcglobal.net
pure clean solar central coast	naranconstinc@gmail.com
Pure Electric	pure.electric@yahoo.com
Pure Energy Solar	pureenergysolar@aol.com
Pure Energy Solar, Inc.	jbowman@gopureenergy.com
Pure Gold Construction	info@puregoldsolar.com
Pure Power Solutions	sales@purepowersolutions.com
Pure Sunlight	showroom@puresunlight.com
Putt Construction	info@sunsupsolar.com
Q-Cells International USA Corp.	b.schubert@q-cells.com
Quality Electric	jonrread@yahoo.com
Quality First Home Improvements	sgabaree@qualityfirsthome.com
Quantum Solar Designs, Inc.	info@qsd1.com
Quantum Solar Services	mark@quantumsolarservices.com
Quattro Solar Inc.	david@quattrosolar.com
R U Solar Construction Corporation	gwmsolar@rusolar.com
R & B Custom Builders Corp	ron@rbcustombuilders.com
R & H Industries	bestelectric888@sbcglobal.net
R & R Construction	randrconstruction@energyfuture.com
R Goodrich Construction	straighttoe@fastmail.fm
R-Link	info@renewableusa.com
R. D. Winkle co.	RDWinkleco@aol.com
R. McClure Electric, Inc	edgugel@sonic.net
R. N. R. Electric	bob194bn@verizon.net
R.B.W. Electric	rbwelectric66@hotmail.com
R.E. Pierro Construction	repierroconstruction@cox.net
R.G Quizon Electric Company	rgquizon@yahoo.com
R.K. Electric	rkelectric.biz@gmail.com
RA Power Solar & Electric	paul@rapowerelectric.com
Raceway Electric	mike@racewayelectric.net
RAD COM	radcomelectric@sbcglobal.net
Rader Electric Inc.	raderst@gmail.com
Rader Electric Incorporated	steve.rader@raderelectric.com
Radiant Energy Corporation (REC)	ak@radiantenergyco.com
Radiant Solar, Inc.	info@radiant-solar.com
Radius Construction	radiussteve@yahoo.com
RAFAEL SALAS	salas1042001@msn.com
Rain Or Shine Power LLC	info@rainorshinepower.com
Raines Electric	Josh@Raineselectric.net
ralos solar	w.barnett@ralosenergy.com
Ralph Pisciotta Electric	pisciottaelectric@sbcglobal.net
RAM Industries	rhanberg@sbcglobal.net
Ramcon Construction	info@sunfusionsolar.com
Ramos Construction, Inc.	builders@ramosconstructoninc.com
Rancho Solar, Inc.	info@ranchosolar.com
Ranco Electric Inc.	tonyrancoelectricinc@gmail.com
Randall Walker Construction	r_walker@att.net
RARE Electric	rw@rareelectric.com
Rasana Corp.	s.hanna@rasanaenergy.com
Rasmussen Construction Inc.	je.rasmussen@yahoo.com
Ray Moss Electric	raymosselectric@hotmail.com
RAY PARSONS	oldpar@yahoo.com
Ray Young Electric Corp.	rayyoung168@gmail.com
Rayco	susanna@raycomail.com
Rayco Electric Inc	ray@raycoelectric.com
Rayco Energy	ricky@raycomail.com
Raygen Inc.	john@raygensolar.com
RB Developing Group Inc.	darwin@rbdeveloping.com
RB Developing Group, Inc.	info@rbdeveloping.com
RBS Solar	rscibelli@rbssolar.com
RBT Electric	ryan@rbt-electric.com
RC Energy Solutions	admin@rcenergysolutions.com
RC Store Maintenance Inc	jill@rcstoremaintenance.com
RD Solar Electrical Systems	rob@rdsolarpower.com
Real Goods Energy Tech Inc	john.schaeffer@realgoods.com
Real Goods Energy Tech, Inc.	Incentives-southbay@realgoods.com
Real Goods Energy Tech, Inc.	Incentives-ukiah@realgoods.com
Real Goods Energy Tech, Inc.	Incentives-murrieta@realgoods.com
Real Goods Energy Tech, Inc.	Incentives-sanrafael@realgoods.com
Real Goods Energy Tech, Inc.	Incentives-southbay@realgoods.com
Real Goods Energy Tech, Inc.	incentives-fresno@realgoods.com
REC Solar, Inc	rebates@recsolar.com
Red Dipper, LLC	doug@reddipper.com
Red Top Electric Co	nickg@teamredtop.com
Reddi Electric	elektrk@gmail.com
Reder Construction, Inc.	rederconstruction@gmail.com
Reed Construction	tomnter63@msn.com
Reef Solar	gogreen@reefsolar.com
Referral Design and Construction Inc	info@referraldesignco.com
Regency Contracting, Inc.	regencycontractinginc@gmail.com
Regency-Pacific Development Corporation	a36bluesky@verizon.net
REGENERATIVE SOLUTIONS	oldhampower@gmail.com
Regional Builders Inc	Matt.Boling@trustrbi.com
ReGreen	diogo@regreencorp.com
Regreen Corp.	peterc@regreencorp.com
Regrid Power Power, Inc. A Real Goods Solar Company	info@regrid.com
Reid Heating & Energy Inc.	reidheating@sbcglobal.net
Reliable Remodelers, Inc.	production@solreliable.com
RELLIM INC	rellim5@yahoo.ca
Remodel USA	robert@remodelusa.com
Rencon Technologies Corp.	alan@rencontechnologies.com
Renew Solar Construction	info@renewsolar4u.com
Renewable Alternative Technologies, Inc.	info@ratechsolar.com
Renewable Electric	clintmotta@renewableelectricinc.com
Renewable Electric Integration	rin@reli.us.com
Renewable Energy Advantage, Inc.	info@renewableusa.com
Renewable Energy Construction By Tower Roofing	bcoxconstruction@aol.com
Renewable Power Solutions, Inc	info@rps-solar.com
Renewable Solar Energy	roland@renewablesolarenergy.us
Renewable Technologies, Inc.	info@renewable.com
Renova Energy Corp.	info@renovasolar.com
Renova Energy Corporation	vincent@renovasolar.com
Renovation Management Associates, Inc.	yakub@broadstreetdirect.com
REP Energy, Inc.	roy@repenergy.com
REP Energy.com	roy@repenergy.com
REP Solar	roy@repenergy.com
repierro construction	repierroconstruction@cox.net
REPOWER Solar Universe	lignacio@solaruniverse.com
REPOWER Solar Universe	lignacio@solaruniverse.com
Residential Energy Assessment Services (REAS), Inc.	info@reasenergy.com
Restart Solar	office@restartsolar.com
Revco Solar Engineering, Inc	richard@revcosolar.com
Revolve Solar	info@revolvesolar.com
Rez Solar & Electric, inc.	rezsolar06@ymail.com
Rez Solar & Electric,inc.	rezsolar06@ymail.com
rh contractor	richardhurst@sbcglobal.net
Richard Herzog Construciton Inc	richard@rhc-inc.net
Richard Herzog Construction Inc.	richard@rhc-inc.net
Ridout Roofing Co., Inc.	ridoutroof@aol.com
Riechers Construction	peter.riechers@gmail.com
Right Now Air	wedothat@sbcglobal.net
Rincon Mill Construction	rinconmill@yahoo.com
Ringer Electric and Solar, Inc	jason@ringerelectric.com
RIOS Solar Energy, INC	info@riosrenovables.com
River City Solar & Electric co.	carl@rivercitysolar.com
Rivero Builders	carlos.rivero@cox.net
RJL Electrical	rjlahr@yahoo.com
RK Electric, Inc.	richard@rkelectric.com
RKCO construction	rkendrick59@yahoo.com
RMS Building, Inc	rmssolardivision@gmail.com
ROAM Solar, Inc.	info@roamsolar.com
Robert D Hill	bobh@rdhill.com
Robert E. Wagner	superair1@hughes.net
Robert Edwin Getz	bobgetz@sti.net
Robert Hauser Construction	bob@bhauser.com
Robert Laughlin Electric	laughelec@gmail.com
Robert Salazar Construction	info@jmtmechanical.com
Robert Wood Construction	Bob@whc.us.com
Robin Trenda General Contracting	chicogreenbuilders@att.net
Robinson Electric	info@norcalsolarserivces.com
Robinson Solar, Inc.	sam@robinsonsolar.com
Robko Construction Inc	info@SolarByRobko.com
Rochlin Corporation	g.rochlin@blue-sky-energy.com
Rock Electric Inc.	rconaty@rockelectric.com
Rock Electric, Inc	arathswohl@rockelectric.com
Rockridge Renewables	info@rockridgerenewables.com
rod wadsworth construction	wadsworthconst@yahoo.com
Rodda Electric Inc.	diedre@roddaelectric.com
rodgers roofing	rodgersroofing@charter.net
Roebbelen Contracting, Inc.	theresaj@roebbelen.com
Roeber's Incorporated	srdamico@roebers.com
Roger	thisisfake@notrealaddress.com
Romi, Inc	jose@romi-jmair.com
Romi, Inc.	jose@romi-jmair.org
Ron Dorris Electric, Inc.	dara@rondorriselectricinc.com
Ron Henry General Contractor	hiron@aol.com
Ron Thorn Construction Inc.	rvt2@ronthorninc.com
Ronald Hardy	hciron@aol.com
Rondoe Electric	rondoe3@msn.com
Rooftop Solar INC	info@rooftopsolar.us
Rooney Construction	peterroo@aim.com
Roots Power	rootsman@suddenlink.net
Rosendin Electric, Inc.	creed@rosendin.com
Roseville Solar Electric	ulrich@rosevillesolar.com
Royal Knight Roofing Co, Inc.	bobenfantino@yahoo.com
RPM Solar Construction Inc.	ben@rpm-solar.com
RS Energy California LLC	david.richards@rsenergyaz.com
RT Maher Construction	richard@rtmaher.com
rudolph electric	rudoplhelectric_solar_xedia@yahoo.com
Ruffa's Electrical Service, Inc	Druffa@sbcglobal.net
Running Electric	jfasolas@gmail.com
Rupert Lyle	lyledesign@yahoo.com
Rupert's Installation Management Service Inc.	info@getsolarsmart.com
ryland warner construction	rylandwarner@att.net
S & R Air Conditioning & Heating, INC.	info@srairconditioning.com
S J M Construction Inc.	sjmconst@yahoo.com.com
S R E Co. Inc.	rkooi@sunriversolar.com
S&F Electric	info@sf-electric-inc.com
S&L Electric	sal5437@gmail.com
S&S Power Engineering Inc	mazen@sspowereng.com
S. E. Valpy Construction and Engineering	svalpy@gmail.com
S.J. CIMINO ELECTRIC	krc@ciminoelectric.com
Sacramento Construction & Electrical	scevisionbuilders@gmail.com
sad	fdsgfsg@hotmail.com
sadflksjdf	seth@isaiahindustries.com
Sadler Solar Development	sadlersolar@gmail.com
Sadler Solar Development	sadlersolar@gmail.com
Safe-Way Electric Co.	glenngross144@yahoo.com
Safetech Construction Inc	bud@safetechconstruction.com
Safeway Building Services, Inc.	dscherneck@safewaybsi.com
Sage Energy Inc.	brad@GoSageEnergy.com
Salinas Valley Roofing	jrlorono@aol.com
Salomone Construction	phil@salomoneconstruction.com
sam zadeh construction	bozorgue@hotmail.com
Sampson Electric	sampsonelectric@yahoo.com
Samuels Electric Services	chrisitne@samuelselectric.com
San Diego County Solar, Inc.	mike@sandiegocountysolar.com
San Diego Solar Install	sandiegosolarinstall@msn.com
San Joaquin Electrical	sandbager@bak.rr.com
San Mateo Cal-Kiwi Roofing, Inc.	calpacroofing@sbcglobal.net
Sandbar Solar & Electric	contact@sandbarsc.com
Sandoval Construction	asan279@comcast.net
Sandra Elizabeth Heck Construction	Builtbyheck@aol.com
Santa Cruz Solar and Solar Electric	andy@santacruzsolar.com
Santa Cruz Westside Electric	sandbar@sandbarsc.com
Santa Ynez Valley Solar	Gary@SYVSolar.com
Sapphire Electric Inc.	tyork@sapphireelectric.com
Sargosis Solar & Electric	contact@sargosis.com
SASHA DELANCHIAN	SASHA.DEL@SBCGLOBAL.NET
Saufley Electric	dsaufley@saufleyelectric.com
Save a Lot Solar	jorfali@savealotsolar.com
SavOn Solar LLC	info@savonsolar.com
Sawmill Solar Electric	sawmillsolar@live.com
Sawtooth Development	sawtoothdev@gmail.com
Sayre Building Performance	info@sayrebuildingperformance.com
SBB ROOFING, INC.	sradenbaugh@yahoo.com
SBR Solar	consult@sbrsolar.com
Scafuri Construction	tina@yorkshireroofing.com
Scantlin Inc.	blscantlin@verizon.net
SCC Electrical	sccsolarpv.sales@gmail.com
SCC Solar Energy, Inc.	SCCsolarenergy@gmail.com
Schaefer Electric Company, Inc.	schaeferelectric@aol.com
Schaible Construction, Inc.	Craigschaible@gmail.com
Schetter Electric Inc	rgarbrick@schetter.com
Schilling Paradise Corp.	jottinger@schilling-paradise.com
Scion Electric, Inc.	solar@scionelectric.com
Scott and Sons Electric	jeff@scottandsons.net
Scott Construction	slower0228@aol.com
Scott Kastning Construction	invenco9@yahoo.com
scott woods general contractor	scottwoods@cox.net
Scotts Valley Construction and Solar	svsolar@hotmail.com
SCP Solar & Green Construction	Steve@scpsolargreenconstruction.com
Scudder Roofing Sun Energy Systems	garrett@scuddersolar.com
Scudder Solar	garrett@scuddersolar.com
Scurfield Solar	ben@scurfieldsolar.com
SDair	sales@sdair.com
SE Construction and Electric	jelmore_edc@yahoo.com
Sea Bright Solar, Inc.	info@seabrightsolar.com
Seal Electric	royb@sealelectric.com
Sean White Solar	sean@pvstudent.com
Sears Construction Co.	searswest@gmail.com
Seaside Electric Inc.	jim@seasideelectric.com
Sebastopol Heat & Cool, Inc.	info@zeroea.com
Sedona West Roofing, Inc.	sedonawest@aol.com
Seisun Electric	seisunelectric@yahoo.com
SEL Construction Corporation	Jayson@selconstruction.com
SEMMES & CO INC	emilym@semmesco.com
Semper Fidelis Construction, Inc.	mark@gosimplesolar.com
Semper Solaris Construction INC	info@sempersolaris.com
Sengoku Solar LLC	sengokusolar@gmail.com
Sensible Solar Construction	mark@sensiblesolar.org
Sentry Roofing Co., Inc.	sentryroof@aol.com
SePac Energy Systems, Inc.	henry@sepacenergy.com
Sepulveda Development	Info@SepulvedaDevelopment.com
Sequoia Energy Services	ses@myenergyupgrades.com
Sequoia Solar	info@sequoiasolar.com
Service First	sonnysolarpro1@gmail.com
Service First Contractors Network	markb@service-1st.com
Service Plus	cliebel@greenstreamsolar.com
Serviceline Providers Unlimited, Inc.	spuconstruction@aol.com
SESCO Electrical Inc.	sescoelectricalinc@gmail.com
SEUSACA, Inc.	dean@solarenergy-usa.net
Seven Electric Inc.	adrian@nextsolarsystems.com
Sexton Electrical Services	sextonelectrical@gmail.com
SFR Solar	info@sfrsolar.com
Shadai Construction, Inc.	shadai.constructions@gmail.com
Shafran Construction	ivan@solartechinnovations.com
Shanks Electric Corporation	shankselectric@shankselectriccorp.com
Shanley Construction Company	1shanley1@verizon.net
Shasta Green Power, Inc	heather@shastagreenpower.com
Shaw's	shaws11@msn.com
SHAYYA ENTERPRISES, INC.	SHAYYA@DESIGNBUILDELECTRIC.COM
she engineering and costruction group inc.	sheconstruction@sbcglobal.net
Shelter Builders	shelterbuilders@comcast.net
Sherpa Solar	mike@sherpasolar.com
Shields Electric	shieldselectric@gmail.com
Shining Light Electric	ShiningLightElectric@msn.com
Shiver Construction Inc	daveshiver@shiverconstructioninc.com
Shoffeitt Construction	mshoffeittconstruction@yahoo.com
SHOKOOR INC.	SHAWN@SUNPOWERGROUP.US
Shorebreak Energy Developers, LLC	info@shorebreakenergy.com
Shoreline Co.	Shorelinecompany@aol.com
ShoreUp, LLC	ecologyelectricco@gmail.com
Sierra Nevada Electric	sierranvelectric@att.net
Sierra Pacific Home & Comfort	marketing@sierrapacifichome.com
Sierra Pacific Roofing	glabbe@sierrapacificroofing.com
Sierra Roofing Systems	jeff@sierraroofing.com
Sierra Single Ply, Inc.	whowes@sierrasingleply.com
Sierra Solar	sierrasolar@schat.net
Sierra Valley Roofing & Construction	sierravalley12@yahoo.com
Sierra Wind and Solar	lubers1@sbcglobal.net
SIGMA SERVICES INC	ben@sigmaservices.net
Signal Alarms & Electric Co	signalarmco@aol.com
Signal Energy, LP	gpawson@signalenergy.com
Signature Solar and Design	ssdsolar@yahoo.com
Siliken USA	siliken.usa@siliken.com
Silver Fox Renewables LLC	silverfoxrenewables@gmail.com
Silver Star Construction INC	malkadns@gmail.com
Silverado Electric	silveradoelec@aol.com
Silveria Electric	fromthesun@att.net
Silverline Home Remodeling Inc.	info@silverlinebuilder.com
Silverwood Energy,Inc.	robert@silverwoodenergy.com
Simmitri	info@simmitri.com
Simple Solar	rickybarnes@simplesolar4u.com
Simply Solar LLC	info@simplysolarelectric.com
Simply Solar, Inc.	production@simplysolarcalifornia.com
Sipovac Construction Inc.	bsipovac@earthlink.net
SIXtwentyONE	ryanheiman@yahoo.com
sj stock construction	jonathonstock@gmail.com
SK Solar	jd@sksolar-usa.com
Skelly Electric	jim@skellyelectric.com
Skelly Electric Inc.	davew@skellyelectric.com
skelton heating and air conditoning	jeff@skeltonhvac.com
Sky General Contractor Co.	richxe@hotmail.com
Sky Power Solar	info@skypowersolar.com
Sky-Cell Technologies, Inc. DBA Sky Cell Solar	Robs@sky-cell.com
Skybridge Renewables, Corp	paul@skybridgerenewables.com
Skyline Energy Savers, Inc	mcskyline@sbcglobal.net
Skyline Energy Solutions, Inc	robs@skylineenergyusa.com
Skyline Sunrooms	ssorensen@sunrooms.com
SKYWAY ELECTRIC	alain.lim@skyway-es.com
Skywest Roofing	rmarion@skywestroofing.com
Slingshot Power PBC	dpritchett@slingshotpower.com
Slingshot Power, pbc	psherer@slingshotpower.com
SLO Circuit Electrical	slocircuit@gmail.com
Smart Energy USA	leo@smartenergyusa.net
Smart Home Remodeling, Inc.	smarthomeremodeling@yahoo.com
Smart Solar Marketing	emaloney@enversolar.com
Smart Solar Network, Inc.	smartsolar1980@gmail.com
Smart Solar Power Inc.	dyoung@SMARTSOLARPOWER.ORG
Smart Systems Technologies, Inc.	ccurran@sstsun.com
Smart. Solar LLC	Mark@smartsolarcorp.com
smart72	accounting@smart72.com
SmartSystem	support@smartsystem.us
Smit's Solar & HVAC	tm@smitssolutions.com
Smith Custom	smthcustom@gmail.com
Smith Service	smithservice@juno.com
SMP Inc	mpaps@cox.net
SN Construction	scott@midcitysolar.com
Snodgrass Electric	tdsnodgrass@msn.com
Snodgrass Electric, Inc.	tdsnodgrass@msn.com
SNOW SOLAR SYSTEMS	jeffpvpower@aol.com
Snyder Electrical	snyderelectrical@gmail.com
So Cal Solar Power	joatessocalsolarpower@verizon.net
So-Cal Solar Inc.	info@socalsolarinc.com
Socal Cities Electrical Inc	socalelectricinc@yahoo.com
SoCal Custom, Inc.	sccsolarenergy@gmail.com
SoCal Solar Energy, Inc.	jim@socal-solar-energy.com
SoCal Solar Group	shawngallerger@live.com
Socal Solar Services Inc	service@socalsolarservices.com
Sodexo Construction, Inc.	Businessandindustry.USA@sodexo.com
Sol Fusion Inc.	info@solfusion.net
SOL POWER CONSTRUCTION, INC.	CONTACT@MYSOLPOWER.COM
Sol R Us	rsamaniego77@hotmail.com
Sol Sierra, Inc.	info@sol-sierra.com
Sol Verde Engineering Solutions	john.r.gildea@solverdesol.com
Sol Wave Solar, Inc.	business@solwavesolar.net
Solagex America	cheryl@solagex.com
Solahart San Martin East Bay	solahart@earthlink.net
Solaire Energy Systems	jarrod@gosolaire.com
Solar Projects Unlimited	John@solar-racks.com
Solar Choice Solutions Inc.	info@solarchoicesolutions.com
Solar Projects Unlimited	John@solar-racks.com
Solar 123 Construction	solar123construction@gmail.com
Solar 360	vcurcie@solar-360.com
Solar Advantage/Jarco Roofing	solaradvantage@verizon.net
Solar Alliance of America, I	cindy@solarallianceofamerica.com
Solar Builders Inc	jterrian@Solar-Builders-Inc.com
SOLAR CAL PARTNERS	briansachau@solarcalpartners.com
Solar Cell Sales.com	info@solarcellsales.com
Solar Center, Inc.	jarom@solarcenterinc.com
Solar Choice Solutions Inc.	info@solarchoicesolutions.com
Solar Club	info@SolarClubUSA.com
Solar Constructors of California Inc.	Bruce@solardevelopmentsolutions.com
Solar Development Inc.	info@solardevelop.com
Solar Distributors, Inc.	solarb1@aol.com
Solar Division	cgeomiller@gmail.com
Solar Ease, Inc	Steve@SolarEase.com
SOLAR ELECTRIC COMPANY	solarelectriccompany@gmail.com
Solar Electric Design a Division of Milton Electric, Inc.	Ian@MrEnergySolar.com
Solar Electric Energy Systems	admin@seesolar.com
Solar Electric Holmes	elizabeth@solarholmes.com
Solar Electric Works	markgipe@cox.net
Solar Electrical Power Worx, Inc.	adam@solarenergyworx.com
Solar Energy Center, Inc.	dmcfall@dc.rr.com
Solar Energy Exchange, Inc.	isaac@solarenergyexchange.net
Solar Energy Group	Sam@sunfreedom.net
Solar Energy Group Inc.	Soliselectric@aol.com
SOLAR ENERGY SOURCES, INC.	arrowmech1@sbcglobal.net
Solar Forward Electric LLC	411@solarforward.com
Solar Fuel	info@solarfuelnow.com
Solar Future LLC	solarfutureusa@yahoo.com
solar fuzion	solarfuzion1@gmail.com
Solar Heating Specialists,Inc.	emery@warmpools.com
Solar Holmes inc	Info@SolarHolmes.com
Solar Horizons	contact@solar-horizons.com
Solar Hut	lukemiller@sbcglobal.net
Solar Independence Inc	solarindependenceq@gmail.com
SOLAR LIGHT WORKERS INC.	mtSolarlightworkers@gmail.com
Solar Lightworkers Inc.	markthompson@ratechsolar.com
Solar Line Energy Inc	hcdynamic@sbcglobal.net
Solar Logic Systems, Inc.	contact@solarlogicSystems.com
Solar Logix	jgdunn@solar-logix.com
Solar Masters	Thesolarpro@aol.com
Solar Network, Inc	ecotas@solaruniverse.com
Solar Network, Inc.	myu@solaruniverse.com
Solar Now	jogomez@evergreenplanet.net
Solar One Corp	sales@solaroneusa.com
Solar One Corp.	parvizd@aol.com
Solar Optimum, Inc	info@solaroptimum.com
Solar Perfect, Inc.	lb@solarperfect.com
SOLAR PLUS	rebates@solar-plus.net
Solar Power Engineer Corporation	sales@solarpowerengineercorp.com
Solar Power Solutions Inc DBA ClarySolar	junaid@clarysolar.com
Solar Power Systems	solarguyjfs@hotmail.com
Solar Power, Inc	Sales@solarpowerinc.net
SOLAR PRICE DISCOVERY INC	ariel@solarpricediscovery.com
Solar Pros	solarproscorp@gmail.com
Solar Pros by Win-Dor	gtemplin@windor-online.com
Solar Pros Inc.	solarprosinc@yahoo.com
Solar Revolt	solarrevolt@comcast.net
solar sense pv	richardh@solarsensepv.com
solar service center	Brad@solarservicecenter.com
SOLAR SERVICING CENTER INC	info@gosolarcenter.com
Solar SGV	nsaxon@solaruniverse.com
SOLAR SOLUTION	ALJH@VERIZON.NET
Solar Solutions 4 U, Inc	stong@solarsolutions4u.com
Solar Solutions, Inc.	sales@reddingsolarsolutions.com
SOLAR SOURCE INC.	info@solarsourcepower.com
SOLAR SOURCE INC.	info@solarsourcepower.com
Solar Spark Electrical	admin@solarsparkelectrical.com
Solar Supports	contactus@campbellwelding.com
Solar System, Inc.	jason@solarsystemsj.com
Solar Systems International, Inc.	cfo@solarsystemsintl.com
Solar Tech International	jason@solartechonline.com
Solar Technologies	jratliff@solartechnologies.com
Solar Training Institute, Inc.	devin@trainingforsolar.com
Solar Universe, Inc.	sales@solaruniverse.com
Solar Unlimited Inc.	sales@solarunlimited.com
Solar Watt Solutions, Inc.	info@solarwattsolutions.com
Solar West Electric, Inc.	rmiller@solarwestelectric.com
Solar West Energy	dryburn7@yahoo.com
Solar Wind Energies	sponseller7@verizon.net
Solar Wind of Alaska	solarwind@aptalaska.net
Solar Wind Works	chris@solarwindworks.com
Solar Works For You	info@solarworksforyou.com
Solar Xpress	alfred@solarxpress.net
Solar-G	jon@solar-g.net
Solar-G Electric Corporation	venita@solar-g.com
Solar-Tec Systems, Inc.	ed@solar-tec.com
Solar4Us	oalmany@sbcglobal.net
SolarAlign, Inc.	info@solaralign.com
SolarChimps	info@solarchimps.com
Solarcity Corporation	info@solarcity.com
Solarco, Inc.	jdurst@solarcosolutions.com
SolarCom Systems	todd.markham@solardomsystems.com
Solarcon	fakhrul@gosolarcon.com
Solarcon	peter@gosolarcon.com
Solarcraft Services, Inc.	bstewart@solarcraft.com
Solare Energy, Inc.	info@SolareEnergy.com
Solare Solar, Inc.	rrecker@SolareSolar.com
Solarflex Contracting Inc.	phillip@kwonlaw.com
SolarHut, LLC	lukemiller@solarhut.org
Solarise, LLC	info@solarisellc.com
SolarMasters	thesolarpro@aol.com
Solarmax Renewable Energy Provider, Inc.	sales@solarmaxtech.com
Solarmax Technology, Inc.	sales@solarmaxtech.com
SolarNorcal, LLC	heath@solarnorcal.com
Solarology Inc	elong@solaruniverse.com
Solaron Pool Heating	rharbeck@solaron.net
Solaropoly, Inc. dba Solar Universe	cshea@solaruniverse.com
Solarpark USA Inc	sales@solarparkusa.com
SolarPod	mouli@mouliengg.com
Solarponics	kristian@solarponics.com
SolarPro Systems	mark@solarprosystems.net
SolarQuest, Inc.	info@solarquestpower.com
SolarRite	ashraf@solarrite.com
Solarrus Corporation	kellyfishback@solarrus.com
Solarscapes USA, Inc.	kgreenman@solarscapesinc.com
SolarTec USA	Fred@SolarTecUSA.com
SolarTech	info@solartechonline.com
SOLARTIME	gosolartime@gmail.com
Solartronics, Inc.	ron@mulick.com
Solarus Electrical Service	clark@solarus.us
SolarVN Inc	vu@solarvn.com
SolarWorld Power Projects Inc.	proposals@solarworldusa.com
Solcius, LLC	accountmanagers@solcius.com
Solcon Solar Construction	rgsolcon@aol.com
SOLECT ELECTRIC	solect@aol.com
SOLectric Electrical Contractor	ruud@solectric.com
SolectricNV Incorporated	chris@solnv.com
SOLEENIC INC	martinbermudez@soleenic.com
Soleez	sales@soleez.com
SOLENERGY ¬Æ	customer-service@solenergyusa.com
Solenergy International	gordonwang@amsolenergy.com
Solex	stan.solex@earthlink.net
Solex Electronics	yousefian@solexenergies.com
Solforce Systems, Inc.	abe@solforce.com
SOLGEN, Inc.	info@solgeninc.com
solis construction	solisconstruction@gmail.com
Sollega	patrick@sollega.com
Solomon Construction	brysondsolomon@gmail.com
Solomon Electric & Data Inc	rp.lusich@me.com
solomon electrical services	solomonelectricalservices@gmail.com
Solready Electric	jordan@solready.com
SolReliable inc	info@solreliable.com
solrise electric company	solrisesolar@gmail.com
Soltec EPC	sales@soltecenergies.com
SOLTECH USA	soltechusa@yahoo.com
Solutions for Utilities, Inc.	mary@solutionsforutilities.com
Solwest Energy	stefan@solwestenergy.com
Son Energy, Inc	kathy@sonenergy.com
Sonce Electric	sonceelectric@gmail.com
Sonray Solar Inc	tom.spr@wavecable.com
SOSOO ELECTRIC	sosooelec@yahoo.com
Sotec Corp	nreitz@sotecsolar.com
South Face	coy@southfacesolarpower.com
South Face Solar Power	coy@southfacesolarpower.com
South Pacific Solar Group	scomckin@aol.com
South Placer	tom@sonrayconstruction.com
South Valley Builders	davesvb@msn.com
souther california construction	forevergreen29@gmail.com
southern califonia construction	forevergreen29@gmail.com
Southern California Energy Alternatives	cmeshack@socaenergy.com
SOUTHERN CALIFORNIA ENERGY ALTERNATIVES, INC	CMESHACK@SOCAENERGY.COM
Southern California Solar Energy	info@socal-solarenergy.com
Southern California Solar Inc.	dena@solarelectricalsystems.com
SouthFace Contracting, Inc.	jeremiah@southfacecontracting.com
Southland E & I Services, Inc.	southland-service@msn.com
southland electrical contractors inc'	info@secelectricinc.com
Southwest Solar Guys Inc.	solar@sowestsg.com
SouthWest Sun Solar, Inc.	summer.tran@southwestsunsolar.com
SP ELECTRICAL SERVICE	spartida@spenergyservice.com
Spartan Electric Systems	davidschoepf@spartanelectricsystems.com
Specialized Energy Inc.	specializedenergy@yahoo.com
Spectra Energy Solutions LLC	randy.arntson@spectraenergysolutions.com
Spectrum Energy Development, Inc.	deosol@aol.com
Spectrum Energy Government Services, Inc.	rheisler@rcsis.com
Spectrum Solarwinds, Inc.	rich@spectrum-solar.com
Sprig Electric	mglogovac@sprigelectric.com
SRC Inc.	sldrck2000@yahoo.com
SRE Solutions	anita@skylite.com
Sri Sai International	srisaiintl@hotmail.com
SSI Systems Inc.	ssisystems@verizon.net
Stan Vierra Electric	stanvierraelectric@yahoo.com
stanford contracting	allprorealtors@yahoo.com
Stanley Louis Co.	stanleylouisco@yahoo.com
Stanton Electric	jstantonelectric@yahoo.com
Star Energy Management, Inc.	heather@starenergyinc.com
Star Kern Inc dba Star Electric	markp@starelectric78.com
Star refrigeration	starrefrigeration@hotmail.com
State Certified Valley Roofing, Inc.	stevegroth@hodgesbuilding.com
Staten Solar Corporation	gosolar@statensolar.com
Stearns Solar	stevestearns63@yahoo.com
Steel Solutions	royce@steelsi.com
Steele Energy Solutions	info@steelesolar.com
Stelcor Energy Corp.	bj@stelcorenergy.com
Stellar Energy GP, INC	info@stellarenergy.com
Steve Anderson Construction	steve.solar@earthlink.net
Steve Childs Electric Inc.	stevechildselectric@yahoo.com
steve cooper construction	flyzwell@msn.com
STEVE GASCA ELECTRICAL INSTALLATIONS	steve.gasca@verizon.net
Steve Herr Construction	sfherr@gmail.com
Steve Little Electric	schachen@gmail.com
Steve Luther Electric	lutherelectric4488@hotmail.com
steve poulos general builder	steveopoulos@yahoo.com
Steve Triolo Electric	trioloelectric@yahoo.com
Stion Corporation	jcheng@stion.com
Stodder Construction, Inc	Stodderconstruction@gmail.com
Stone Roofing Co., Inc.	craig@stoneroof.com
Stout & Burg Electric, Inc.	erica@sbeoc.com
Straight Line Roofing and Construction	ben@straightlineconstruction.com
Stringer Construction	embert@verizon.net
STRONG ELECTRIC	ADAM.LARNER@STRONGELECTRIC.COM
Stronghold Engineering, Inc.	nw@teamsei.com
Sullivan Solar Power	info@sullivansolarpower.com
Summit Technology Group, Inc.	service@summit-e.com
Sun 2 Energy Renewables, Inc.	bill@sun2energy.net
Sun Assets	Mrousset@sunassetsca.com
SUN BOSS ENERGY	carlo@sunbossenergy.com
Sun Chariot Solar Corp	sales@sunchariotsolar.com
Sun Dollar Solar	sales@sundollarsolar.com
Sun Economy Construction, Inc	sunecinc@gmail.com
Sun Elect Inc	jparker@sunelectricinc.com
Sun Electric	sunelectricco@aol.com
Sun First Inc.	info@sunfirstsolar.com
Sun Freedom, Inc	pstojkov@sunfreedom.net
Sun Harvester, Inc.	marie.sunharvester@gmail.com
Sun Integration	dean@suninteg.com
Sun King Solar Inc.	info@sunkingsolarpv.com
Sun Light & Power	info@sunlightandpower.com
Sun Marshall Solar Services	marshall@sunmarshall.com
Sun Metrics	sarah@sunmetrics.com
Sun Pacific Solar Electric, Inc.	sunpacificsolar@cox.net
Sun Pirate, Inc.	ret-training@sunpirate.com
Sun Plug Inc.	shanelathrom@gmail.com
Sun Power Construction	kevin@sunpowerconstruction.com
Sun Powered Solutions, Inc.	richard@sunpoweredsolutions.com
Sun Running Electric	jfasolas@gmail.com
Sun Smart Inc.	dquinn@sunsmartus.com
Sun Solar	info@sunsolarpros.com
Sun Solar Electric	jfermamdes@sunsolarelectric.org
Sun Solar Energy Solutions	info@sunenergyhome.com
Sun Source Electric	wsloniker@sunsourceelectric.org
Sun Source Industries, Inc	riccb@susoind.com
Sun Tap Solar Inc.	rodrohrs@yahoo.com
Sun Valley Solar Inc	shirley@sunvalleysolarinc.com
Sun X Solar Inc	dan@sunxsolar.com
Sun's Free Solar	info@sunsfreesolar.com
sun-brite electric	sunbriteelectric@gmail.com
Sun-Tricity Solar Power	richardkabbany@sun-tricity.com
Sun2Energy Renewables	chris@sun2energy.net
Sun2Energy Renewables, Inc	Kay@Sun2Energy.net
SunAmericaSolar	MarkKirchen@comcast.net
Sunbelt Solar Systems	sunbelt4solar@verizon.net
Sunbolt Energy Solutions Inc	info@sunboltenergysolutions.com
SUNBOSS ENERGY & PLUMBING	cc22917@gmail.com
SUNBREEZE ELECTRIC	jvillalobos11615@yahoo.com
Sunburst Solar Energy, Inc	david@sbsolarenergy.com
SunCal Solar, Inc	robert@suncalsolar.com
SunCraft Solar, Inc.	info@suncraftsolar.com
SunCraftsmen	suncraftsmen@gmail.com
SunCraftsmen Solar	john@suncraftsmensolar.com
Sundial Solar	jeremyb@sundial4solar.com
Sundowner Solar	britt@SundownerSolar.com
Sunergy California LLC	stephen.nelson@bbs-la.com
Sunergy Power	drewjkim@yahoo.com
Sunergy Power Corporation	drewjkim@yahoo.com
Sunfinity Solar- Ca, LLC	bchristian@sunfinitysolar.com
SunFirst! Solar	info@sunfirstsolar.com
Sunforce Solar, Inc	simonkrek@sbcglobal.net
SunFreedom, Inc	sunfreedom2@gmail.com
SUNFUSION SOLAR	sandy@sunfusionsolar.com
SunFusion Solar Electric Inc	design@sunfusionsolar.com
Sungate Energy Solutions, Inc.	hlunde@thesungate.com
Sungenia Solar Solutions	msnell@sungenia.com
Sungenix Energy Solutions	sungenix@gmail.com
Sungevity Inc.	Info@sungevity.com
Sungrade Solar, Inc	info@sungradesolar.com
SunGreen Systems, Inc	bennytse@sungreensystems.com
SunHarvest Solar	eric@harvesthesun.com
Sunleaf	tony@sun-leaf.com
Sunlectric, Inc	joe@sunlectric.net
SunLife Solar	Pramirez@SunLifeSolarCo.com
Sunlight Solar	jc@sunlight4solar.com
Sunline Energy	matt@sunlineenergy.com
Sunlite Technology Group	info@sunlite-e.com
SunliteEnergy	dtobias@sunlite-energy.com
SunLogic, Inc.	info@sunlogicsolar.com
Sunny Green Solar	dbuckley@sunnygreensolar.com
Sunny Solar Electric	michaelcourson@yahoo.com
SunnyCal Solar Inc	sales@sunnycalsolar.com
SunnyCal Solar Inc	Becky@sunnycalsolar.com
SunPower Corporation, Systems	residentialservice@sunpowercorp.com
SunPower Electric Inc.	sunpower4u@mac.com
SunPower Services	chris@sunpower-services.com
Sunpro Solar Inc.	evans.adamj@gmail.com
SunQuest Energy, Inc.	hudson@sunquestenergy.com
Sunra Corporation	jon@srcbuild.com
Sunray Solar Systems	scott.higgins@sbcglobal.net
Sunrise Energy Group Inc	Admin@sunriseenergygroup.com
SUNRISE ENERGY SOLUTIONS INC	INFO@SES-SOLAR.COM
Sunrise Power	qualityfiberglasspools@yahoo.com
Sunrise Power Inc.	eric@sunrisepowerinc.com
Sunrise Roofing	tmars8@aol.com
Sunrise Roofing Supply, L.L.C.	tmars8@aol.com
Sunrise Solar co..	jreichardt@ftcnet.net
Sunrise Solar Roofing, Inc.	david@sunrisesolarroofing.com
Sunriver Solar	rkooi@sunriversolar.com
Sunrun	info@sunrun.com
Suns Up Solar	info@sunsupsolar.com
Sunsational Solar INC	henry@sunsationalsolarinc.com
Sunscape Solar, Inc	sunscapesolarenergy@yahoo.com
Sunset Electrical Contractors, Inc.	something@something.com
Sunshine Solar Energy, Inc.	rheng22@hotmail.com
sunshine solar trading	sunshinesolartrading@gmail.com
Sunshine Solar, LLC	venicesunshinesolar@gmail.com
SunSolar US, Inc.	kobi@sunsolarus.com
SUNSPOT SOLAR Mechanical & Electrical	sunspotthom@gmail.com
Sunstall Inc	info@sunstall.com
Sunstar Energy, Inc.	info@sunstarenergy.com
Sunstar Precision Energy Corp. Inc.	ronaldb@sunefx.net
SunStarter Solar Installations Inc	steve@sunstarter.net
Sunstrand Energy, Inc.	jim@sunstrandenergy.com
Sunstruction	solar@sunstruction.com
Sunsystem Solar	vic@sunsystemsolar.com
SunTech Energy	SunTechEnergyUSA@gmail.com
Sunterra Solar Inc.	cbunas@sunterrapower.com
Sunthurst Energy, LLC	daniel@sunthurstenergy.com
Suntrek Industries	dan@suntreksolar.com
Suntricity, Inc.	joyce@solarsuntricity.com
SunUp Energy	rick@rothmansolar.com
Sunvalley Solar Inc.	info@sunvalleysolarinc.com
SunVest Solar Electric	joe@sunvestsolar.com
Sunview Vineyards of California, Inc.	johnfleeman@sunviewcoldstorage.com
Sunwest Energy Group	sunwestenergy@ymail.com
Sunwize Technologies	heveland@sunwize.com
SunWork Renewable Energy Projects	info@sunwork.org
SunWorks Power and Electric	david@sunworkspower.com
Sunworks Solar Power	info@sunworksusa.com
SUNX Solar Inc.	sunxsolar@live.com
Super Cool Air & Solar Electric	supercoolair@aol.com
Super Happy Solar Company	mlichtenberger42@gmail.com
Super Solar	supersolar@sbcglobal.net
SuperGreen Solutions Oceanside	marks@supergreensolutions.com
Superior Building	Superior-Building@comcast.net
Supreme Air Systems	breanna@supremeair.net
Supreme Construction	supreme@supremeconstruction.us
Sustainable Buildings System Inc	billphua@yahoo.com
Sustainable Development International Inc.	contact@sandiegosolarbroker.com
Sustainable Electric Solutions, Inc.	info@sustainsp.com
Sustainable Energy Group Inc.	raydarby@sustainableenergygroup.com
Sustainable Energy Solutions	josh@senergynow.com
Sustainable Solutions	lisaarosen@gmail.com
Sustainable Solutions Partners	info@sustainsp.com
Sustainable Technologies	solar@sustainabletech.cc
Sustineo Solar Systems Inc.	dhandman@sustineosolarsystems.com
Sutter Brothers	bsutter@hotmail.com
SVB	mauiforever689@yahoo.com
Swale Electric	swale-electric@pacbell.net
Swanrock	info@skytechsolar.com
Sweitzer Solar Solutions	sweitzersolarsolutions@gmail.com
Swinerton Builders	gfrench@swinerton.com
Symons Electric Inc	bsymons@symonselectric.com
Synapse Electric	info@synapseelectric.com
Synergetik LLC	hello@brightensolarco.com
Synergy Corporation	marlin.magic@sbcglobal.net
Synergy Electric Company, Inc.	jerryzapata@synergyelectric.com
Synergy Solar & Electrical Systems, Inc.	sales@synsolar.com
Syntrol Plumbing, Heating & Air Inc	todd@syntrol.net
Syntrol Plumbing, Heating & Air, Inc	Syntrol@syntrol.net
System 3 Inc.	tomd@system3inc.com
System Electric Co., Inc.	rstephens@systemelectric.com
Systematic Construction, Inc	kjhuang14@yahoo.com
T & G Roofing and Roof Removal	tom@tgroofs.com
T and M Solar	tim@tandmsolar.com
T S J Electrical & Communications Inc	lisa@mastersec.com
T.A.K. ELECTRIC INC.	TAK@TAK-ELECTRICAL.COM
T.Perry and Sons Roofing	craigtperryandsons@yahoo.com
Taft Electric CO.	creed@taftelectric.com
Taft Electric Company	brian@taftsolar.com
Tahoe Solar Designs	solar@tahoesolardesigns.com
TAK Electric Inc.	tak@tak-electrical.com
Talbott Solar & Radiant Homes Inc	info@talbottsolar.com
Talent Air	brent@talentair.com
Tanner Industries	david.tanner@wsp.com
taylor electric	tbone@ftcnet.net
Taylor Energy Systems	seantaylor29@yahoo.com
TD Construction Electric & Solar	Tim@TDConstruction.net
Tech Electric	troy@techelectric.net
Technical Electrical Inc.	matt@teasolar.com
Technion Contractors Inc.	office@technioncontractors.com
Technology Builders	technologybuilders@comcast.net
Tecnospot Solar USA, Inc.	info@tecnospotsolar.com
Tecta America	rrabe@tectaamerica.com
Ted Barcley Co.	thebarcleys@msn.com
Ted M Sirjesse Construction inc	ted@tmsconst.com
Tekton Inc	mike@tektonsolar.com
Tel Tech Plus, Inc.	cdunn@ttp-us.com
TelfordJones Inc.	jonesphac@hotmail.com
Tellmen Electric	tellmenelectric@yahoo.com
tempco	tempcoac@aol.com
Tenant Improvement Construction & Consulting, Inc	mjbettis@comcast.net
TENCO SOLAR, INC.	TENCOSOLAR@yahoo.com
Terawatt Construction Inc.	terawatt@juno.com
Terra Aqua Builders Inc.	Office@erinow.com
Terra Bella Solar	info@terrabellasolar.com
Terry Shelton Construction	tbsheltonsr@netptc.net
TGS Inc.	tgsgasman@hughes.net
Thaleez Solar Electric	hectormurva@thaleezsolarelectric.com
That Solar Guy	jeff@thatsolarguy.com
The CALWAY Group, Inc.	mb234@calway.com
The Chastain Building Group, Inc .	chastain_design@yahoo.com
The Crest Company	dthomas@thecrestcompany.com
The Ecovery Project	ecovery@lmi.net
The Electric Touch Co.	i.arie@verizon.net
The Electrical Pros Inc	Solar@TheElectricalPros.com
The electrician inc	The.electrician.inc@gmail.com
The Excellent Builders	theexcellentbuilders@earthlink.net
the green store inc.	info@gr8energy.com
The Juiceman	mr.juiceman@yahoo.com
The O.K. Earl Corporation	sarlotti@earlcorp.com
The Only Electricians On Earth	reidworth@aol.com
THE POWER CONNECTION CO.	PWRCONN@YAHOO.COM
The Remodelors, Inc.	Info@NorthStateSolarEnergy.com
The Ryan Company, Inc.	cbradley@ryancompany.net
The Solar Company	rachelle@thesolarco.com
The Solar Energy Company	sean@thesolarenergycompany.com
The Solar Energy Company, Inc	chris@thesolarenergycompany.com
The Sun Connection	sales@thesunconnection.com
The Sun Is Yours Inc	info@thesunisyours.com
The United Solar Inc (TSI)	Info@theunitedsolar.com
THE UNITED SOLAR, INC	info@theunitedsolar.com
The Vasquez Group	rvasquez@vasquezgroup.com
The Wall Construction Company	carlos@thewallconstruction.com
The"Go To" Guy Construction	kboersma1@cox.net
Therien Construction & RT Solar	rick@rtsolar.com
Thermal Cool Inc.	dcouch@thermalcool.com
Thern Electric, INC	davew@thernelectric.com
Third Generation Electric	thirdgenerationelectric@yahoo.com
Third Millennium Electrical LLC	jt@3rdmillenniumelectric.com
Thoma Electric, Inc	sarnold@thomaelec.com
Thomas Cote Electric	thomas@mountainsolar.net
Thomas G. Fiori Construction	tom@fioriconstruction.com
Thomas King	serviceconnection@yahoo.com
Thomas Rose Electric, Inc.	thomasroseelectric@cox.net
Thomsen Roofing	mike@thomsenroofing.com
Three Oaks Construction, Inc.	threeoaksone@cs.com
Three Phase Electric, Inc.	kim@hoalighting.com
Thurman Construction	erik.dyrr@gmail.com
TIGER ELECTRIC, INC.	MDITSLER@TIGERELECTRIC.COM
Time-4-Solar, Inc.	marty@time-4-solar.com
Timothy Houston	timhouston03@gmail.com
Tital Plumbing Ltd.	sarah@dndphc.com
Titan Plumbing LTD	officemanager@dndphc.com
TKD Builders, Inc.	tkdo53@yahoo.com
TKG West Inc	info@tkgsolar.com
TL ELECTRIC	timl@att.net
TLP ELECTRIC INTEGRATIONS INC.	TIM@INFINITYELECTRIC.NET
TLP Electric Integrations, inc.	robyn@tlpsolar.com
TMAG Industries	info@stellarsolar.net
TMW & Associates, Inc.	TWBogart@TMWandAssociates.com
TNC Solar Electric Inc.	tncsolarelectric@gmail.com
TNG Electric	info@tngelectric.com
TNJ Electric, Inc.	timatharris@aol.com
Todd Brown Construction	tbc@pacbell.net
Tolly Inc	Joel@tollyinc.com
Tom Alexander Electric	tom-alexander@att.net
Tom Dietz Construction	carl.dietz@gmail.com
Tom McGrail Roofing Inc.	tommcgrail.roofing.solar@gmail.com
Tom Pryor Electric & General Cont.	tom.noyoriver@sbcglobal.net
Tone Framing	info@tonesolar.com
Top Hat Energy inc	info@tophatenergy.com
Top Notch Electric	topnotchelectric@yahoo.com
Torga Electrical	creyesjr84@gmail.com
Torres Electric Inc.	snahmad@yahoo.com
Total Concept Sales, Inc.	solar@totalups.com
Toucan Construction and Solar, Inc.	info@toucanconstruction.com
tower electric	rdelatorre909@yahoo.com
Tr-County Solar	wcsolar@ymail.com
Trane US Inc	mketcham@trane.com
Trapsun Solar	trapsunsolar@gmail.com
Travalini & Sons Contruction, Inc.	CatchTSun@aol.com
Travalini Construction & Solar	GaryWaren@aol.com
Travis Robson Construction	travisbrobson@hotmail.com
TRC "The Renewable Company"	greentechsocal@gmail.com
TRConstruction	travisbrobson@hotmail.com
Tree Hugger Solar	jmelloni@sunsetbuildingdevelopment.com
Tri D Associated Builders, Inc.	tridabinc@me.com
TRI POINT IMPROVEMENTS	markdufaultgc@yahoo.com
Tri Security Electronic Surveillance	trisound@comcast.net
Tri-County Grading	tri-countygrading@hotmail.com
Trillia Associates	georgetrillia@comcast.net
Trim Rite, Inc.	jerry@trimrite.net
Trinidad Electric	trinidade@humboldt1.com
Triwest Asset Management, Inc.	osulli3166@aol.cm
Trobaugh Electric	jacktrobaugh@sbcglobal.net
Trombino Electric	jaat@comcast.net
Troy Criswell Construction	Tacriswell@gmail.com
Troy R Helton, Jr.	wrldflyr@verizon.net
TruePower Solar	info@truepowersolar.com
TSK Management & Construction, Inc	tskhanllc@gmail.com
Tubeo Industries, LLC	info@raxindustries.com
TUF Guys	info@tufguys.com
TWENTY-FOUR / SEVEN ELECTRIC CO	xxiv7usa@yahoo.com
Twisted Pair Inc	clinton@twistedpairsolar.com
Twisted Pair Solar	clinton@intergrate.com
Ukiah Electric	brandon@ukiahconstruction.com
Ulrich Energy & Solar	lee@ulrichenergy.con
Under the Sun Solar	bob@camplehmann.com
underline energy concepts	cell2you@yahoo.com
UNhique construction	UNhique@gmail.com
uniacke electric	pvuniacke@hotmail.com
Unique Energy Solutions	cme4greensolutions@gmail.com
Unique Home Design & Remodeling inc.	ericd@sahlcon.com
Unique Solar	uniquesolar@att.net
United Contractors Inc.	jimg@unitedcontractors.com
United Electric	adrian.unitedelectric@gmail.com
United Electrical Services	danielle@unitedelectricalservices.com
United Energy Engineering Corpration	phuh2@ca.rr.com
UNITED STATES SOLAR	cmeshack@unitedstatessolar.com
United Sun Energy	rgrattidge@unitedsunenergy.com
Universal Solar Inc	Universalsolarinc@cox.net
Universal Wiring	universalwiring@hotmail.com
Universal Wiring LLC	admin@universalwiringca.com
Universal Wiring, LLC	Paul.Prado@live.com
University City Photons	ucphotons@gmail.com
Unleaded Design	gcorda@skypowersolar.com
Unleash Solar LLC	jose@unleashsolar.com
Unlimited Energy Solar Solutions	vcreese@unlimited-energy.com
Up on the Roof, Inc.	tcroney@msn.com
Urban Design Solar	sean@urbandesignsolar.com
Urban Energy	mark@urbanenergysolar.com
Uribes General Contracting	jose@ugcsolar.com
US Green Builders	suz@usgbi.com
US GREEN ENERGY TECHNOLOGIES	ajsaenz@usgreen.co
USA Solar Solutions	sales@usasolarsolutions.com
Utility Builders Corp.	utilitybuilders@earthlink.net
Utility Conservation Services	darina@utilityconservationservices.com
V Development, Inc.	mike.capital@sbcglobal.net
V&H Electric Inc	Info@VHElectricInc.com
V3 Electric	rep@v3electric.com
Vagi Development, Inc.	gaborvagi@gmail.com
Valencia Roofing	valenciaroofing@msn.com
Valencia Western Electric	monty@valenciawestern.com
Valley Air Conditioning & Repair Inc.	Brian.var@earthlink.net
Valley Center Solar Electrical, Inc	TimB@ValleyCenterSolar.org
Valley Energy Construction, Inc.	dpuku@solaruniverse.com
Valley Pacific Builders, Inc.	valleypacific@sbcglobal.net
Valley Solar Solutions, INC	Todd@valleysolarsolutions.net
Valley Solar, Inc	info@valley-solar.com
Valley Unique Electric	kira@valleyunique.com
Van Elk Ltd	info@vanelkltd.com
Van's Electric Co., Inc.	larry@larryvan.com
Vanguard Solar Technologies	vanguardsolar@comcast.net
Vanir Energy LLC	jose.radzinsky@vanirenergy.com
Vasco Solar Energy Construction	vascosolar@earthlink.net
VCD CORP	hvizcarra@vcdcorp.net
Velocity Solar Power, Inc.	darin@velocitysolar.com
Venco Solar Construction	vencoandpardue@gmail.com
Verdi Energy Inc	adie.folker@gmail.com
Verengo Solar	info@verengosolar.com
Verengo Solar Plus	kbutton@goverengo.com
VerengoSolar	verengosolar@verengosolar.com
Vertacore Inc.	dan@vertacore.net
Via Solar Corp	davidfkim@viasolarcorp.com
Victory Heating and Air	service@victoryheatingandair.com
Viking Electrical	vikingelectrical144@gmail.com
Villa Construction	vcconstruction@verizon.net
Village Power Design	gosolar@villagepowerdesign.com
Vinatieri Construction	vinatieribuilders@comcast.net
Vincenet Engineering	ted@vincentengineering.com
Vintage Electric and Solar	james@vintageelectric.us
Vista Solar, Inc.	sales@vista-solar.com
Vivint Solar Developer, LLC	solarlicensing@vivntsolar.com
Volta Solar Inc	gosolar@voltasolarinc.com
Votech,Inc.	fortiz@votechgse.com
Vucina Construction, Inc.	vucinaconstruction@yahoo.com
W C Exterior Company	max@westcoastexteriors.com
W. L. Vickers Construction, Inc	wvickersconst@aol.com
W. L. Vickers Construction, Inc	walt@wlvickersconstruction.com
W3 Solar	W3solar@gmail.com
Wade-Austen Inc	builders-plus@msn.com
Waggener Electric, Inc.	service@waggenerelectric.com
Walton Electric Corporation	ryan@waltonelectriccorp.com
Ware Construction	coy@southfacesolarpower.com
Warm Corporation West	offadmin@warmfloors.com
Water Works Construction, Inc.	pete@waterworksconstruction.net
WATT Electric Inc.	josh@wattelectricinc.com
Watts New Under the Sun,	info@wattsnewsolar.com
Watts New Under The Sun, Inc.	info@wattsnew.org
Watts Up Electric	wattsupelectric1@gmail.com
Wave Electric	wave220@gmail.com
Waves Electrical Construction	mchalfant@yahoo.com
Wayne Electric	jim@g4av.com
Webb Air	Jeff@webbairchico.com
Wedge Electric	Rob@WedgeElectric.com
weeks construction service and repair	weekscsr@live.com
Wegen Solar Inc.	sahn@wegensolar.com
Weiner Development Company	solarrebates@yahoo.com
WePOWER LLC	sales@wepower.us
West Coast Construction	bigdaddyatwcc@yahoo.com
West Coast Green Electric	sboersma@mywestcoastgreen.com
West Coast Power Solutions	mike@controlsandelectrical.com
West Coast Solar	Mikea1917@gmail.com
West Coast Solar Energy	nate@westcoastsolarenergy.com
West Coast Solar, Inc.	jefferyt@westcoastsolar.com
West Coast Sustainables	jason@westcoastsustainables.com
West Hills Construction, Inc.	rwood@whcsolar.com
West Pacific Electric Company	westpacificelectricco@gmail.com
West Valley Solar & Electric	wvse@sbcglobal.net
western broadband communications	twesternbc007@aol.com
Western Electrical Contracting	oequihua.wec@gmail.com
Western Pacific Roofing Corp.	ronwinkle@westpacroof.com
Western Pacific Solar Corp	info@westpacsolar.com
Western Pacific Solar Corp.	info@westpacsolar.com
western sierra	westernsierra@yahoo.com
Western Solar	westernsolar@cox.net
Western Sun Enterprises	dwhitt@threedelectric.com
Western Sun Systems	jim@westernsunsystems.com
Westhaven Inc.	info@westhavenconstruction.com
Whipple Electric	whippleelectric@sisqtel.net
White Knight Home Services	info@knighthomeservices.com
White Oak Energy Inc	richard@whiteoakenergy.net
Whitehead Construction	paul@wcdoors.com
Whiteside Construction	whitesideconstruction@gmail.com
Whitney Collins Builder Inc	whitneycollinsbuilderinc@gmail.com
Whitney Collins Builder, Inc.	whitneycollinsbuilderinc@gmail.com
Whittier Power Systems Inc.	lharrison@harrisonelectric.com
Wiggins Electric Inc.	dean@wigginselectric.com
Wildwood Pools	jeffk@wildwoodpools.com
Wildwood Total Solar	jeffk@wildwoodpools.com
Wilko Electrical	wilkinsonalwyn@yahoo.com
William E Carter Company, Inc.	william@williamecartercompany.com
William H McCarty Electric	mccshock@aol.com
William Worthey Electrical	wortheyw@gmail.com
Williams Homes, Inc.	kbrown@williamshomes.com
WILLITS ELECTRTIC	pisciottaelectric@sbcglobal.net
Willow Glen Electric, Inc.	info@willowglenelectric.com
Willy Heating and Air Conditioning	jun.zhuge@willyenergy.com
Wilson Electric	wilsonelectricoc@yahoo.com
Windtex, Inc	vspwindtex@yahoo.com
Windwood Designs	djcarpenter1@sbcglobal.net
Wing Solar & Wood Energy	alanwing@clearwire.net
Wired Into The Future Inc.	info@wiredintothefuture.com
Wiring Solutions Inc	wiringsolutions@verizon.net
Wollam Solar	mark@wollamsolar.com
wommack electric	Wommackelectric@gmail.com
Wonder Electric Co. Inc.	jojnjr@wonderelectric.com
Wong Greentech	lai@wonggreentech.com
Woodcrest Construction	cidevco@sbcglobal.net
Woods Electric & Solar	shaunwoodselectric@yahoo.com
Wooster Engineering	woosteraquatic@live.com
Worldwide Construction	haimshiri@walla.com
Wright Building Co.	wrightbuildingco@gmail.com
WYE DELTA SYSTEMS, INC.	bruno@barrwestelectric.com
Xero Solar	info@xerosolar.com
Xnergy	jason@xnergy.com
XsunX, Inc.	sales@xsunx.com
Xtreme Construction Inc.	jason@xtremeconstructioninc.com
Yancey Home Improvement	tom.yancey@yanceycompany.com
Yang Construction	yangconst@gmail.com
Yes! Construction Services	Sales@yessolarsolutions.com
Yochheim Group	yochheimgroup@hotmail.com
Youn's Environmental Services	welink2@gmail.com
Young's Air Conditioning	cyoung@youngsair.com
Your Energy Source	i-save@4-yes.com
YouVee Solar	info@youveesolar.com
Zachammer Construction	zjirkovsky@gmail.com
Zachary Domich Solar	zdomich@solarixsolar.com
Zamora's Electric Inc	zamoraselectric06@att.net
Zapata Construction	zapataconstruction@hotmail.com
Zegers Electric	alicezegers@verizon.net
Zember Construction	pvmanagerca@gmail.com
Zen Electric	zenelectric@yahoo.com
Zenergy Design, Inc.	zenergy@saber.net
Zero Energy Contracting, Inc.	mike@zeroenergyco.com
Zeronet Energy Solutions, Inc.	ggoodsell@znesolutions.com
Zeronet Energy, Inc.	bwilkins@znesolutions.com
Zhongri Liu	liusconstruction@yahoo.com
Zigma Electric	allennazar@yahoo.com
Zing Solar	jimmy@zingsolar.com
Zing Solar	jimmy@zingsolar.com
Zip Electric	zipelec@zipelectric.us
zurn eletric	blair@delsdistributing.com
Zus Solar & Wind, Inc	eric@zussolar.com
zz testing (Fake business)	kj4you@love.com
